hic	hic	ADV	_	
portus	portus	NN	number=PLURAL|gender=MASCULINE|case=ACCUSATIVE	
alii	alius	NN	number=PLURAL|gender=MASCULINE|case=NOMINATIVE	
effodiunt	exfodio	VB	person=PERSON_3|number=PLURAL|tense=PR|mood=INDICATIVE|voice=ACTIVE	
hic	hic	ADV	_	
alta	altus	ADJ	number=PLURAL|gender=NEUTER|case=ACCUSATIVE	
theatris	theatrum	NN	number=PLURAL|gender=NEUTER|case=DATIVE	
fundamenta	fundamentum	NN	number=PLURAL|gender=NEUTER|case=ACCUSATIVE	
locant	loco	VB	person=PERSON_3|number=PLURAL|tense=PR|mood=INDICATIVE|voice=ACTIVE	
alii	alius	NN	number=PLURAL|gender=MASCULINE|case=NOMINATIVE	
immanis	immanis	ADJ	number=PLURAL|gender=FEMININE|case=ACCUSATIVE	
-que	que	CONJ	_	
columnas	columna	NN	number=PLURAL|gender=FEMININE|case=ACCUSATIVE	
rupibus	rupes	NN	number=PLURAL|gender=FEMININE|case=ABLATIVE	
excidunt	excido	VB	person=PERSON_3|number=PLURAL|tense=PR|mood=INDICATIVE|voice=ACTIVE	
scaenis	scaena	NN	number=PLURAL|gender=FEMININE|case=DATIVE	
decora	decus	NN	number=PLURAL|gender=NEUTER|case=ACCUSATIVE	
alta	altus	ADJ	number=PLURAL|gender=NEUTER|case=ACCUSATIVE	
futuris	sum	VB	number=PLURAL|tense=FUTURE|mood=PARTICIPLE|voice=ACTIVE|gender=FEMININE|case=DATIVE	
Corripuere	corripio	VB	person=PERSON_3|number=PLURAL|tense=PERF|mood=INDICATIVE|voice=ACTIVE	
viam	via	NN	number=SINGULAR|gender=FEMININE|case=ACCUSATIVE	
interea	interea	ADV	_	
qua	qua	ADV	_	
semita	semita	NN	number=SINGULAR|gender=FEMININE|case=NOMINATIVE	
monstrat	monstro	VB	person=PERSON_3|number=SINGULAR|tense=PR|mood=INDICATIVE|voice=ACTIVE	
Infert	infero	VB	person=PERSON_3|number=SINGULAR|tense=PR|mood=INDICATIVE|voice=ACTIVE	
se	sui	PRON	number=SINGULAR|gender=MASCULINE|case=ACCUSATIVE	
saeptus	saepio	VB	number=SINGULAR|tense=PERF|mood=PARTICIPLE|voice=PASSIVE|gender=MASCULINE|case=NOMINATIVE	
nebula	nebula	NN	number=SINGULAR|gender=FEMININE|case=ABLATIVE	
mirabile	mirabilis	ADJ	number=SINGULAR|gender=NEUTER|case=NOMINATIVE	
dictu	dico	NN	number=SINGULAR|mood=SUBJUNCTIVE|gender=NEUTER|case=DATIVE	
per	per	PREP	_	
medios	medius	ADJ	number=PLURAL|gender=MASCULINE|case=ACCUSATIVE	
miscet	misceo	VB	person=PERSON_3|number=SINGULAR|tense=PR|mood=INDICATIVE|voice=ACTIVE	
-que	que	CONJ	_	
viris	vir	NN	number=PLURAL|gender=MASCULINE|case=DATIVE	
ne	ne	ADV	_	
-que	que	CONJ	_	
cernitur	cerno	VB	person=PERSON_3|number=SINGULAR|tense=PR|mood=INDICATIVE|voice=PASSIVE	
ulli	ullus	ADJ	number=SINGULAR|gender=MASCULINE|case=DATIVE	
â€œO	o	EXCL	_	
fortunati	fortuno	VB	number=PLURAL|tense=PERF|mood=PARTICIPLE|voice=PASSIVE|gender=MASCULINE|case=VOCATIVE	
quorum	qui	PRON	number=PLURAL|gender=MASCULINE|case=GENITIVE	
iam	jam	ADV	_	
moenia	moenia	NN	number=PLURAL|gender=NEUTER|case=NOMINATIVE	
surgunt	surgo	VB	person=PERSON_3|number=PLURAL|tense=PR|mood=INDICATIVE|voice=ACTIVE	
Aeneas	Aeneas	NN	number=SINGULAR|gender=MASCULINE|case=NOMINATIVE	
ait	aio	VB	person=PERSON_3|number=SINGULAR|tense=PR|mood=INDICATIVE|voice=ACTIVE	
et	et	CONJ	_	
fastigia	fastigium	NN	number=PLURAL|gender=NEUTER|case=ACCUSATIVE	
suspicit	suspicio	VB	person=PERSON_3|number=SINGULAR|tense=PR|mood=INDICATIVE|voice=ACTIVE	
urbis	urbs	NN	number=SINGULAR|gender=FEMININE|case=GENITIVE	
Iam	jam	ADV	_	
-que	que	CONJ	_	
ascendebant	ascendo	VB	person=PERSON_3|number=PLURAL|tense=IMP|mood=INDICATIVE|voice=ACTIVE	
collem	collis	NN	number=SINGULAR|gender=MASCULINE|case=ACCUSATIVE	
qui	qui	PRON	number=SINGULAR|gender=MASCULINE|case=NOMINATIVE	
plurimus	plurimus	ADJ	number=SINGULAR|gender=MASCULINE|case=NOMINATIVE	
urbi	urbs	NN	number=SINGULAR|gender=FEMININE|case=DATIVE	
imminet	immineo	VB	person=PERSON_3|number=SINGULAR|tense=PR|mood=INDICATIVE|voice=ACTIVE	
adversas	adverro	VB	number=PLURAL|tense=PERF|mood=PARTICIPLE|voice=PASSIVE|gender=FEMININE|case=ACCUSATIVE	
-que	que	CONJ	_	
adspectat	adspecto	VB	person=PERSON_3|number=SINGULAR|tense=PR|mood=INDICATIVE|voice=ACTIVE	
desuper	desuper	ADV	_	
arces	arx	NN	number=PLURAL|gender=FEMININE|case=ACCUSATIVE	
Qualis	qualis	ADJ	number=SINGULAR|gender=MASCULINE|case=NOMINATIVE	
apes	apis	NN	number=PLURAL|gender=FEMININE|case=ACCUSATIVE	
aestate	aestas	NN	number=SINGULAR|gender=FEMININE|case=ABLATIVE	
nova	novus	ADJ	number=SINGULAR|gender=FEMININE|case=ABLATIVE	
per	per	PREP	_	
florea	floreus	ADJ	number=PLURAL|gender=NEUTER|case=ACCUSATIVE	
rura	rus	NN	number=PLURAL|gender=NEUTER|case=ACCUSATIVE	
exercet	exerceo	VB	person=PERSON_3|number=SINGULAR|tense=PR|mood=INDICATIVE|voice=ACTIVE	
sub	sub	PREP	_	
sole	sol	NN	number=SINGULAR|gender=MASCULINE|case=ABLATIVE	
labor	labor	NN	number=SINGULAR|gender=MASCULINE|case=NOMINATIVE	
cum	cum	CONJ	_	
gentis	gens	NN	number=SINGULAR|gender=FEMININE|case=GENITIVE	
adultos	adolesco	VB	number=PLURAL|tense=PERF|mood=PARTICIPLE|voice=PASSIVE|gender=MASCULINE|case=ACCUSATIVE	
educunt	educo	VB	person=PERSON_3|number=PLURAL|tense=PR|mood=INDICATIVE|voice=ACTIVE	
fetus	fetus	NN	number=PLURAL|gender=MASCULINE|case=ACCUSATIVE	
aut	aut	CONJ	_	
cum	cum	CONJ	_	
liquentia	liqueo	VB	number=PLURAL|tense=PR|mood=PARTICIPLE|gender=NEUTER|case=ACCUSATIVE	
mella	mel	NN	number=PLURAL|gender=NEUTER|case=ACCUSATIVE	
stipant	stipo	VB	person=PERSON_3|number=PLURAL|tense=PR|mood=INDICATIVE|voice=ACTIVE	
et	et	CONJ	_	
dulci	dulcis	ADJ	number=SINGULAR|gender=NEUTER|case=ABLATIVE	
distendunt	distendo	VB	person=PERSON_3|number=PLURAL|tense=PR|mood=INDICATIVE|voice=ACTIVE	
nectare	nectar	NN	number=SINGULAR|gender=NEUTER|case=ABLATIVE	
cellas	cella	NN	number=PLURAL|gender=FEMININE|case=ACCUSATIVE	
aut	aut	CONJ	_	
onera	onus	NN	number=PLURAL|gender=NEUTER|case=ACCUSATIVE	
accipiunt	accipio	VB	person=PERSON_3|number=PLURAL|tense=PR|mood=INDICATIVE|voice=ACTIVE	
venientum	venio	VB	number=PLURAL|tense=PR|mood=PARTICIPLE|voice=ACTIVE|gender=MASCULINE|case=GENITIVE	
aut	aut	CONJ	_	
agmine	agmen	NN	number=SINGULAR|gender=NEUTER|case=ABLATIVE	
facto	facio	VB	number=SINGULAR|tense=PERF|mood=PARTICIPLE|voice=PASSIVE|gender=NEUTER|case=ABLATIVE	
ignavom	ignavus	ADJ	number=SINGULAR|gender=NEUTER|case=ACCUSATIVE	
fucos	fucus	NN	number=PLURAL|gender=MASCULINE|case=ACCUSATIVE	
pecus	pecus	NN	number=SINGULAR|gender=NEUTER|case=ACCUSATIVE	
a	ab	PREP	_	
praesepibus	praesaepe	NN	number=PLURAL|gender=NEUTER|case=ABLATIVE	
arcent	arceo	VB	person=PERSON_3|number=PLURAL|tense=PR|mood=INDICATIVE|voice=ACTIVE	
fervet	ferveo	VB	person=PERSON_3|number=SINGULAR|tense=PR|mood=INDICATIVE|voice=ACTIVE	
opus	opus	NN	number=SINGULAR|gender=NEUTER|case=NOMINATIVE	
redolent	redoleo	VB	person=PERSON_3|number=PLURAL|tense=PR|mood=INDICATIVE|voice=ACTIVE	
-que	que	CONJ	_	
thymo	thymum	NN	number=SINGULAR|gender=NEUTER|case=ABLATIVE	
fragrantia	fragro	VB	number=PLURAL|tense=PR|mood=PARTICIPLE|gender=NEUTER|case=NOMINATIVE	
mella	mel	NN	number=PLURAL|gender=NEUTER|case=NOMINATIVE	
Instant	insto	VB	person=PERSON_3|number=PLURAL|tense=PR|mood=INDICATIVE|voice=ACTIVE	
ardentes	ardeo	VB	number=PLURAL|tense=PR|mood=PARTICIPLE|gender=MASCULINE|case=NOMINATIVE	
Tyrii	Tyrius	ADJ	number=PLURAL|gender=MASCULINE|case=NOMINATIVE	
pars	pars	NN	number=SINGULAR|gender=FEMININE|case=NOMINATIVE	
ducere	duco	VB	tense=PR|mood=INFINITIVE|voice=ACTIVE	
muros	murus	NN	number=PLURAL|gender=MASCULINE|case=ACCUSATIVE	
moliri	molior	VB	tense=PR|mood=INFINITIVE|voice=PASSIVE	
-que	que	CONJ	_	
arcem	arx	NN	number=SINGULAR|gender=FEMININE|case=ACCUSATIVE	
et	et	CONJ	_	
manibus	manus	NN	number=PLURAL|gender=FEMININE|case=ABLATIVE	
subvolvere	subvolvo	VB	tense=PR|mood=INFINITIVE|voice=ACTIVE	
saxa	saxum	NN	number=PLURAL|gender=NEUTER|case=ACCUSATIVE	
pars	pars	NN	number=SINGULAR|gender=FEMININE|case=NOMINATIVE	
optare	opto	VB	tense=PR|mood=INFINITIVE|voice=ACTIVE	
locum	locus	NN	number=SINGULAR|gender=MASCULINE|case=ACCUSATIVE	
tecto	tectum	NN	number=SINGULAR|gender=NEUTER|case=DATIVE	
et	et	CONJ	_	
concludere	concludo	VB	tense=PR|mood=INFINITIVE|voice=ACTIVE	
sulco	sulcus	NN	number=SINGULAR|gender=MASCULINE|case=ABLATIVE	
(instant)			_	
Miratur	miror	VB	person=PERSON_3|number=SINGULAR|tense=PR|mood=INDICATIVE|voice=PASSIVE	
molem	moles	NN	number=SINGULAR|gender=FEMININE|case=ACCUSATIVE	
Aeneas	Aeneas	NN	number=SINGULAR|gender=MASCULINE|case=NOMINATIVE	
magalia	magalia	NN	number=PLURAL|gender=NEUTER|case=ACCUSATIVE	
quondam	quondam	ADV	_	
miratur	miror	VB	person=PERSON_3|number=SINGULAR|tense=PR|mood=INDICATIVE|voice=PASSIVE	
portas	porta	NN	number=PLURAL|gender=FEMININE|case=ACCUSATIVE	
strepitum	strepitus	NN	number=SINGULAR|gender=MASCULINE|case=ACCUSATIVE	
-que	que	CONJ	_	
et	et	CONJ	_	
strata	stratum	NN	number=PLURAL|gender=NEUTER|case=ACCUSATIVE	
viarum	via	NN	number=PLURAL|gender=FEMININE|case=GENITIVE	
