hic	hic	ADV	_	
nullus	nullus	ADJ	number=SINGULAR|gender=MASCULINE|case=NOMINATIVE	
verbis	verbum	NN	number=PLURAL|gender=NEUTER|case=DATIVE	
pudor	pudor	NN	number=SINGULAR|gender=MASCULINE|case=NOMINATIVE	
aut	aut	CONJ	_	
reverentia	reverentia	NN	number=SINGULAR|gender=FEMININE|case=NOMINATIVE	
mensae	mensa	NN	number=SINGULAR|gender=FEMININE|case=DATIVE	
,	unknown		_	
hic	hic	ADV	_	
turpis	turpis	ADJ	number=SINGULAR|gender=MASCULINE|case=NOMINATIVE	
Cybeles	Cybele	NN	number=SINGULAR|gender=FEMININE|case=GENITIVE	
et	et	CONJ	_	
fracta	frango	VB	number=SINGULAR|tense=PERF|mood=PARTICIPLE|voice=PASSIVE|gender=FEMININE|case=ABLATIVE	
voce	vox	NN	number=SINGULAR|gender=FEMININE|case=ABLATIVE	
loquendi	loquor	VB	number=SINGULAR|tense=PR|mood=GERUND|voice=DEPONENS|case=GENITIVE	
libertas	libertas	NN	number=SINGULAR|gender=FEMININE|case=NOMINATIVE	
et	et	CONJ	_	
crine	crinis	NN	number=SINGULAR|gender=MASCULINE|case=ABLATIVE	
senex	senex	NN	number=SINGULAR|gender=MASCULINE|case=NOMINATIVE	
fanaticus	fanaticus	ADJ	number=SINGULAR|gender=MASCULINE|case=NOMINATIVE	
albo	albus	ADJ	number=SINGULAR|gender=MASCULINE|case=ABLATIVE	
sacrorum	sacrum	NN	number=PLURAL|gender=NEUTER|case=GENITIVE	
antistes	antistes	NN	number=SINGULAR|gender=MASCULINE|case=NOMINATIVE	
rarum	rarus	ADJ	number=SINGULAR|gender=NEUTER|case=NOMINATIVE	
ac	atque	CONJ	_	
memorabile	memorabilis	ADJ	number=SINGULAR|gender=NEUTER|case=NOMINATIVE	
magni	magnus	ADJ	number=SINGULAR|gender=NEUTER|case=GENITIVE	
gutturis	guttur	NN	number=SINGULAR|gender=NEUTER|case=GENITIVE	
exemplum	exemplum	NN	number=SINGULAR|gender=NEUTER|case=NOMINATIVE	
conducendus	conduco	VB	number=SINGULAR|mood=GERUNDIVE|gender=MASCULINE|case=NOMINATIVE	
que	que	CONJ	_	
magister	magister	NN	number=SINGULAR|gender=MASCULINE|case=NOMINATIVE	
.	unknown		_	
aspice	aspicio	VB	person=PERSON_2|number=SINGULAR|tense=PR|mood=IMPERATIVE|voice=ACTIVE	
quid	quis	PRON	number=SINGULAR|gender=NEUTER|case=ACCUSATIVE	
faciant	facio	VB	person=PERSON_3|number=PLURAL|tense=PR|mood=SUBJUNCTIVE|voice=ACTIVE	
commercia	commercium	NN	number=PLURAL|gender=NEUTER|case=NOMINATIVE	
quaero	quaero	VB	person=PERSON_1|number=SINGULAR|tense=PR|mood=INDICATIVE|voice=ACTIVE	
an	an	CONJ	_	
deceant	decet	VB	person=PERSON_3|number=PLURAL|tense=PR|mood=SUBJUNCTIVE|voice=ACTIVE	
multicia	multicia	NN	number=PLURAL|gender=NEUTER|case=NOMINATIVE	
testem	testis	NN	number=SINGULAR|gender=MASCULINE|case=ACCUSATIVE	
.	unknown		_	
steriles	sterilis	ADJ	number=PLURAL|gender=MASCULINE|case=NOMINATIVE	
moriuntur	morior	VB	person=PERSON_3|number=PLURAL|tense=PR|mood=INDICATIVE|voice=PASSIVE	
et	et	CONJ	_	
illis	ille	PRON	number=PLURAL|gender=FEMININE|case=DATIVE	
turgida	turgidus	ADJ	number=SINGULAR|gender=FEMININE|case=NOMINATIVE	
non	non	ADV	_	
prodest	prosum	VB	person=PERSON_3|number=SINGULAR|tense=PR|mood=INDICATIVE|voice=ACTIVE	
condita	condo	VB	number=SINGULAR|tense=PERF|mood=PARTICIPLE|voice=PASSIVE|gender=FEMININE|case=ABLATIVE	
pyxide	pyxis	NN	number=SINGULAR|gender=FEMININE|case=ABLATIVE	
Lyde	Lyde	NN	number=SINGULAR|gender=FEMININE|case=NOMINATIVE	
ne	ne	ADV	_	
-c	que	CONJ	_	
prodest	prosum	VB	person=PERSON_3|number=SINGULAR|tense=PR|mood=INDICATIVE|voice=ACTIVE	
agili	agilis	ADJ	number=SINGULAR|gender=MASCULINE|case=DATIVE	
palmas	palma	NN	number=PLURAL|gender=FEMININE|case=ACCUSATIVE	
praebere	praebeo	VB	tense=PR|mood=INFINITIVE|voice=ACTIVE	
luperco	Lupercus	NN	number=SINGULAR|gender=MASCULINE|case=DATIVE	
magna	magnus	ADJ	number=SINGULAR|gender=FEMININE|case=NOMINATIVE	
inter	inter	PREP	_	
molles	mollis	ADJ	number=PLURAL|gender=MASCULINE|case=ACCUSATIVE	
concordia	concordia	NN	number=SINGULAR|gender=FEMININE|case=NOMINATIVE	
.	unknown		_	
sed	sed	CONJ	_	
tu	tu	PRON	number=SINGULAR|gender=MASCULINE|case=VOCATIVE	
vera	verus	ADJ	number=PLURAL|gender=NEUTER|case=ACCUSATIVE	
puta	puto	VB	person=PERSON_2|number=SINGULAR|tense=PR|mood=IMPERATIVE|voice=ACTIVE	
en	en	EXCL	_	
habitum	habitus	NN	number=SINGULAR|gender=MASCULINE|case=ACCUSATIVE	
quo	qui	PRON	number=SINGULAR|gender=MASCULINE|case=ABLATIVE	
te	tu	PRON	number=SINGULAR|gender=MASCULINE|case=ACCUSATIVE	
leges	lex	NN	number=PLURAL|gender=FEMININE|case=ACCUSATIVE	
ac	atque	CONJ	_	
iura	ius	NN	number=PLURAL|gender=NEUTER|case=ACCUSATIVE	
ferentem	fero	VB	number=SINGULAR|tense=PR|mood=PARTICIPLE|gender=MASCULINE|case=ACCUSATIVE	
vulneribus	vulnus	NN	number=PLURAL|gender=NEUTER|case=ABLATIVE	
crudis	crudus	ADJ	number=PLURAL|gender=NEUTER|case=ABLATIVE	
populus	populus	NN	number=SINGULAR|gender=MASCULINE|case=NOMINATIVE	
modo	modo	ADV	_	
victor	victor	NN	number=SINGULAR|gender=MASCULINE|case=NOMINATIVE	
et	et	CONJ	_	
illud	ille	PRON	number=SINGULAR|gender=NEUTER|case=NOMINATIVE	
montanum	montanus	ADJ	number=SINGULAR|gender=NEUTER|case=NOMINATIVE	
positis	pono	VB	number=PLURAL|tense=PERF|mood=PARTICIPLE|voice=PASSIVE|gender=NEUTER|case=ABLATIVE	
audiret	audio	VB	person=PERSON_3|number=SINGULAR|tense=IMP|mood=SUBJUNCTIVE|voice=ACTIVE	
vulgus	vulgus	ADJ	number=SINGULAR|gender=NEUTER|case=NOMINATIVE	
aratris	aratrum	NN	number=PLURAL|gender=NEUTER|case=ABLATIVE	
sed	sed	CONJ	_	
quid	quis	PRON	number=SINGULAR|gender=NEUTER|case=ACCUSATIVE	
non	non	ADV	_	
facient	facio	VB	person=PERSON_3|number=PLURAL|tense=FUTURE|mood=INDICATIVE|voice=ACTIVE	
alii	Alius	ADJ	number=PLURAL|gender=MASCULINE|case=NOMINATIVE	
cum	Cum	CONJ	_	
tu	tu	PRON	number=SINGULAR|gender=MASCULINE|case=NOMINATIVE	
multicia	multicia	NN	number=PLURAL|gender=NEUTER|case=ACCUSATIVE	
sumas	sumo	VB	person=PERSON_2|number=SINGULAR|tense=PR|mood=SUBJUNCTIVE|voice=ACTIVE	
Cretice	Creticus	ADJ	number=SINGULAR|gender=MASCULINE|case=VOCATIVE	
et	et	CONJ	_	
hanc	hic	PRON	number=SINGULAR|gender=FEMININE|case=ACCUSATIVE	
vestem	vestis	NN	number=SINGULAR|gender=FEMININE|case=ACCUSATIVE	
populo	populus	NN	number=SINGULAR|gender=MASCULINE|case=ABLATIVE	
mirante	miror	VB	number=SINGULAR|tense=PR|mood=PARTICIPLE|gender=MASCULINE|case=ABLATIVE	
perores	peroro	VB	person=PERSON_2|number=SINGULAR|tense=PR|mood=SUBJUNCTIVE|voice=ACTIVE	
in	in	PREP	_	
Proculas	Procula	NN	number=PLURAL|gender=FEMININE|case=ACCUSATIVE	
et	et	CONJ	_	
Pollittas	Pollitta	NN	number=PLURAL|gender=FEMININE|case=ACCUSATIVE	
est	sum	VB	person=PERSON_3|number=SINGULAR|tense=PR|mood=INDICATIVE|voice=ACTIVE	
moecha	moecha	NN	number=SINGULAR|gender=FEMININE|case=NOMINATIVE	
Fabulla	Fabulla	NN	number=SINGULAR|gender=FEMININE|case=NOMINATIVE	
,	comma	CONJ	_	
damnetur	damno	VB	person=PERSON_3|number=SINGULAR|tense=PR|mood=SUBJUNCTIVE|voice=PASSIVE	
si	si	CONJ	_	
vis	volo	VB	person=PERSON_2|number=SINGULAR|tense=PR|mood=INDICATIVE|voice=ACTIVE	
etiam	etiam	ADV	_	
Carfinia	Carfinia	NN	number=SINGULAR|gender=FEMININE|case=NOMINATIVE	
nudus	nudus	ADJ	number=SINGULAR|gender=MASCULINE|case=NOMINATIVE	
agas	ago	VB	person=PERSON_2|number=SINGULAR|tense=PR|mood=SUBJUNCTIVE|voice=ACTIVE	
sed	sed	CONJ	_	
tamen	tamen	ADV	_	
unde	unde	ADV	_	
haec	hic	ADJ	number=PLURAL|gender=NEUTER|case=ACCUSATIVE	
emis	emo	VB	person=PERSON_2|number=SINGULAR|tense=PR|mood=INDICATIVE|voice=ACTIVE	
hirsuto	hirsutus	ADJ	number=SINGULAR|gender=NEUTER|case=ABLATIVE	
spirant	spiro	VB	person=PERSON_3|number=PLURAL|tense=PR|mood=INDICATIVE|voice=ACTIVE	
opobalsama	opobalsamum	NN	number=PLURAL|gender=NEUTER|case=ACCUSATIVE	
collo	collum	NN	number=SINGULAR|gender=NEUTER|case=ABLATIVE	
quae	qui	PRON	number=PLURAL|gender=NEUTER|case=NOMINATIVE	
tibi	tu	PRON	number=SINGULAR|gender=MASCULINE|case=DATIVE	
Foedius	foedus	ADJ	number=SINGULAR|gender=NEUTER|case=ACCUSATIVE|degree=COMPARATIVE	
hoc	hic	PRON	number=SINGULAR|gender=MASCULINE|case=ABLATIVE	
aliquid	aliquis	PRON	number=SINGULAR|gender=NEUTER|case=ACCUSATIVE	
quandoque	quandoque	ADV	_	
audebis	audeo	VB	person=PERSON_2|number=SINGULAR|tense=FUTURE|mood=INDICATIVE|voice=ACTIVE	
amictu	amictus	NN	number=SINGULAR|gender=MASCULINE|case=ABLATIVE	
dives	dives	NN	number=SINGULAR|gender=FEMININE|case=NOMINATIVE	
erit	sum	VB	person=PERSON_3|number=SINGULAR|tense=FUTURE|mood=INDICATIVE|voice=ACTIVE	
magno	magnus	ADJ	number=SINGULAR|gender=MASCULINE|case=ABLATIVE	
quae	qui	PRON	number=SINGULAR|gender=FEMININE|case=NOMINATIVE	
dormit	dormio	VB	person=PERSON_3|number=SINGULAR|tense=PR|mood=INDICATIVE|voice=ACTIVE	
tertia	tertius	ADJ	number=SINGULAR|gender=FEMININE|case=NOMINATIVE	
lecto	lectus	NN	number=SINGULAR|gender=MASCULINE|case=ABLATIVE	
vitreo	vitreus	ADJ	number=SINGULAR|gender=MASCULINE|case=ABLATIVE	
bibit	bibo	VB	person=PERSON_3|number=SINGULAR|tense=PR|mood=INDICATIVE|voice=ACTIVE	
ille	ille	PRON	number=SINGULAR|gender=MASCULINE|case=NOMINATIVE	
priapo	Priapus	NN	number=SINGULAR|gender=MASCULINE|case=ABLATIVE	
reticulum	reticulum	NN	number=SINGULAR|gender=NEUTER|case=ACCUSATIVE	
que	que	CONJ	_	
comis	coma	NN	number=PLURAL|gender=FEMININE|case=ABLATIVE	
auratum	auro	VB	number=SINGULAR|tense=PERF|mood=PARTICIPLE|voice=PASSIVE|gender=NEUTER|case=ACCUSATIVE	
ingentibus	ingens	ADJ	number=PLURAL|gender=FEMININE|case=ABLATIVE	
implet	impleo	VB	person=PERSON_3|number=SINGULAR|tense=PR|mood=INDICATIVE|voice=ACTIVE	
caerulea	caeruleus	ADJ	number=PLURAL|gender=NEUTER|case=ACCUSATIVE	
indutus	induo	VB	number=SINGULAR|tense=PERF|mood=PARTICIPLE|voice=PASSIVE|gender=MASCULINE|case=NOMINATIVE	
scutulata	scutulatus	ADJ	number=PLURAL|gender=NEUTER|case=ACCUSATIVE	
aut	aut	CONJ	_	
galbina	galbina	NN	number=PLURAL|gender=NEUTER|case=ACCUSATIVE	
rasa	rado	VB	number=PLURAL|tense=PERF|mood=PARTICIPLE|voice=PASSIVE|gender=NEUTER|case=ACCUSATIVE	
et	et	ADV	_	
per	per	PREP	_	
Iunonem	Juno	NN	number=SINGULAR|gender=FEMININE|case=ACCUSATIVE	
domini	dominus	NN	number=SINGULAR|gender=MASCULINE|case=GENITIVE	
iurante	juro	VB	number=SINGULAR|tense=PR|mood=PARTICIPLE|gender=MASCULINE|case=ABLATIVE	
ministro	minister	ADJ	number=SINGULAR|gender=MASCULINE|case=ABLATIVE	
quid	quis	PRON	number=SINGULAR|gender=NEUTER|case=ACCUSATIVE	
enim	enim	ADV	_	
falsi	falsum	NN	number=SINGULAR|gender=NEUTER|case=GENITIVE	
Laronia	Laronia	NN	number=SINGULAR|gender=FEMININE|case=NOMINATIVE	
scilicet	scilicet	ADV	_	
horreres	horreo	VB	person=PERSON_2|number=SINGULAR|tense=IMP|mood=SUBJUNCTIVE|voice=ACTIVE	
maiora	magnus	ADJ	number=PLURAL|gender=NEUTER|case=ACCUSATIVE|degree=COMPARATIVE	
que	que	CONJ	_	
monstra	monstrum	NN	number=PLURAL|gender=NEUTER|case=ACCUSATIVE	
putares	puto	VB	person=PERSON_2|number=SINGULAR|tense=IMP|mood=SUBJUNCTIVE|voice=ACTIVE	
,	unknown		_	
si	si	CONJ	_	
mulier	mulier	NN	number=SINGULAR|gender=FEMININE|case=NOMINATIVE	
vitulum	vitulus	NN	number=SINGULAR|gender=MASCULINE|case=ACCUSATIVE	
vel	vel	CONJ	_	
si	si	CONJ	_	
bos	bos	NN	number=SINGULAR|gender=FEMININE|case=NOMINATIVE	
ederet	edo	VB	person=PERSON_3|number=SINGULAR|tense=IMP|mood=SUBJUNCTIVE|voice=ACTIVE	
agnum	agnus	NN	number=SINGULAR|gender=MASCULINE|case=ACCUSATIVE	
de	de	PREP	_	
nobis	nos	PRON	number=PLURAL|gender=FEMININE|case=ABLATIVE	
post	post	PREP	_	
haec	hic	ADJ	number=PLURAL|gender=NEUTER|case=ACCUSATIVE	
tristis	tristis	ADJ	number=SINGULAR|gender=FEMININE|case=NOMINATIVE	
sententia	sententia	NN	number=SINGULAR|gender=FEMININE|case=NOMINATIVE	
fertur	fero	VB	person=PERSON_3|number=SINGULAR|tense=PR|mood=INDICATIVE|voice=PASSIVE	
hispida	hispidus	ADJ	number=PLURAL|gender=NEUTER|case=NOMINATIVE	
membra	membrum	NN	number=PLURAL|gender=NEUTER|case=NOMINATIVE	
quidem	quidem	ADV	_	
et	et	CONJ	_	
durae	durus	ADJ	number=PLURAL|gender=FEMININE|case=NOMINATIVE	
per	per	PREP	_	
bracchia	bracchium	NN	number=PLURAL|gender=NEUTER|case=ACCUSATIVE	
saetae	saeta	NN	number=PLURAL|gender=FEMININE|case=NOMINATIVE	
promittunt	promitto	VB	person=PERSON_3|number=PLURAL|tense=PR|mood=INDICATIVE|voice=ACTIVE	
atrocem	atrox	ADJ	number=SINGULAR|gender=MASCULINE|case=ACCUSATIVE	
animum	animus	NN	number=SINGULAR|gender=MASCULINE|case=ACCUSATIVE	
sed	sed	CONJ	_	
podice	podex	NN	number=SINGULAR|gender=MASCULINE|case=ABLATIVE	
levi	levis	ADJ	number=SINGULAR|gender=MASCULINE|case=ABLATIVE	
caeduntur	caedo	VB	person=PERSON_3|number=PLURAL|tense=PR|mood=INDICATIVE|voice=PASSIVE	
tumidae	tumidus	ADJ	number=PLURAL|gender=FEMININE|case=NOMINATIVE	
medico	medicus	ADJ	number=SINGULAR|gender=MASCULINE|case=ABLATIVE	
ridente	rideo	VB	number=SINGULAR|tense=PR|mood=PARTICIPLE|gender=MASCULINE|case=ABLATIVE	
mariscae	marisca	NN	number=PLURAL|gender=FEMININE|case=NOMINATIVE	
sed	sed	CONJ	_	
melius	bonus	ADJ	number=SINGULAR|gender=NEUTER|case=NOMINATIVE|degree=COMPARATIVE	
quod	quod	CONJ	_	
nil	nihil	NN	number=SINGULAR|gender=NEUTER	
animis	animus	NN	number=PLURAL|gender=MASCULINE|case=DATIVE	
in	in	PREP	_	
corpora	corpus	NN	number=PLURAL|gender=NEUTER|case=ACCUSATIVE	
iuris	jus	NN	number=SINGULAR|gender=NEUTER|case=GENITIVE	
natura	natura	NN	number=SINGULAR|gender=FEMININE|case=NOMINATIVE	
indulget	indulgeo	VB	person=PERSON_3|number=SINGULAR|tense=PR|mood=INDICATIVE|voice=ACTIVE	
sed	sed	CONJ	_	
Iulius	Iulius	NN	number=SINGULAR|gender=MASCULINE|case=NOMINATIVE	
ardet	ardeo	VB	person=PERSON_3|number=SINGULAR|tense=PR|mood=INDICATIVE|voice=ACTIVE	
,	comma	CONJ	_	
aestuo	aestuo	VB	person=PERSON_1|number=SINGULAR|tense=PR|mood=INDICATIVE|voice=ACTIVE	
.	unknown		_	
"	unknown		_	
Quadringenta	quadringenti	ADJ	number=PLURAL|gender=NEUTER|case=ACCUSATIVE	
dedit	do	VB	person=PERSON_3|number=SINGULAR|tense=PERF|mood=INDICATIVE|voice=ACTIVE	
Gracchus	Gracchus	NN	number=SINGULAR|gender=MASCULINE|case=NOMINATIVE	
sestertia	sestertium	NN	number=PLURAL|gender=NEUTER|case=ACCUSATIVE	
dotem	dos	NN	number=SINGULAR|gender=FEMININE|case=ACCUSATIVE	
cornicini	cornicen	NN	number=SINGULAR|gender=MASCULINE|case=DATIVE	
si	sive	CONJ	_	
-ve	sive	CONJ	_	
hic	hic	PRON	number=SINGULAR|gender=MASCULINE|case=NOMINATIVE	
recto	rectus	ADJ	number=SINGULAR|gender=MASCULINE|case=ABLATIVE	
cantaverat	canto	VB	person=PERSON_3|number=SINGULAR|voice=ACTIVE	
aere	aer	NN	number=SINGULAR|gender=MASCULINE|case=ABLATIVE	
segmenta	segmentum	NN	number=PLURAL|gender=NEUTER|case=ACCUSATIVE	
et	et	CONJ	_	
longos	longus	ADJ	number=PLURAL|gender=MASCULINE|case=ACCUSATIVE	
habitus	habitus	NN	number=PLURAL|gender=MASCULINE|case=ACCUSATIVE	
et	et	CONJ	_	
flammea	flammeus	ADJ	number=PLURAL|gender=NEUTER|case=ACCUSATIVE	
sumit	sumo	VB	person=PERSON_3|number=SINGULAR|tense=PR|mood=INDICATIVE|voice=ACTIVE	
arcano	arcanus	ADJ	number=SINGULAR|gender=NEUTER|case=ABLATIVE	
qui	qui	PRON	number=SINGULAR|gender=MASCULINE|case=NOMINATIVE	
sacra	sacrum	NN	number=PLURAL|gender=NEUTER|case=ACCUSATIVE	
ferens	fero	VB	number=SINGULAR|tense=PR|mood=PARTICIPLE|gender=MASCULINE|case=NOMINATIVE	
nutantia	nuto	VB	number=PLURAL|tense=PR|mood=PARTICIPLE|gender=NEUTER|case=ACCUSATIVE	
loro	lorum	NN	number=SINGULAR|gender=NEUTER|case=ABLATIVE	
sudavit	sudo	VB	person=PERSON_3|number=SINGULAR|tense=PERF|mood=INDICATIVE|voice=ACTIVE	
clupeis	clipeus	NN	number=PLURAL|gender=MASCULINE|case=ABLATIVE	
ancilibus	ancilis	ADJ	number=PLURAL|gender=MASCULINE|case=ABLATIVE|degree=POSITIVE	
faciunt	facio	VB	person=PERSON_3|number=PLURAL|tense=PR|mood=INDICATIVE|voice=ACTIVE	
nam	nam	ADV	_	
plura	multus	ADJ	number=PLURAL|gender=NEUTER|case=ACCUSATIVE	
sed	sed	CONJ	_	
illos	ille	PRON	number=PLURAL|gender=MASCULINE|case=ACCUSATIVE	
defendit	defendo	VB	person=PERSON_3|number=SINGULAR|tense=PR|mood=INDICATIVE|voice=ACTIVE	
numerus	numerus	NN	number=SINGULAR|gender=MASCULINE|case=NOMINATIVE	
iunctae	jungo	VB	number=PLURAL|tense=PERF|mood=PARTICIPLE|voice=PASSIVE|gender=FEMININE|case=NOMINATIVE	
que	que	CONJ	_	
umbone	umbo	NN	number=SINGULAR|gender=MASCULINE|case=ABLATIVE	
phalanges	phalanx	NN	number=PLURAL|gender=FEMININE|case=NOMINATIVE	
.	unknown		_	
Esse	sum	VB	tense=PR|mood=INFINITIVE|voice=ACTIVE	
aliquos	aliquis	PRON	number=PLURAL|gender=MASCULINE|case=ACCUSATIVE	
manes	Manes	NN	number=PLURAL|gender=MASCULINE|case=ACCUSATIVE	
et	et	CONJ	_	
subterranea	subterraneus	ADJ	number=PLURAL|gender=NEUTER|case=ACCUSATIVE	
regna	regnum	NN	number=PLURAL|gender=NEUTER|case=ACCUSATIVE	
Cocytum	Cocytus	NN	number=SINGULAR|gender=MASCULINE|case=ACCUSATIVE	
et	et	CONJ	_	
Stygio	Stygius	ADJ	number=SINGULAR|gender=MASCULINE|case=ABLATIVE	
ranas	rana	NN	number=PLURAL|gender=FEMININE|case=ACCUSATIVE	
in	in	PREP	_	
gurgite	gurges	NN	number=SINGULAR|gender=MASCULINE|case=ABLATIVE	
nigras	niger	ADJ	number=PLURAL|gender=FEMININE|case=ACCUSATIVE	
atque	atque	CONJ	_	
una	unus	ADJ	number=SINGULAR|gender=FEMININE|case=ABLATIVE	
transire	transeo	VB	tense=PR|mood=INFINITIVE|voice=ACTIVE	
vadum	vadum	NN	number=SINGULAR|gender=NEUTER|case=ACCUSATIVE	
tot	tot	ADV	_	
milia	mille	NN	number=SINGULAR|gender=NEUTER|case=ACCUSATIVE	
cumba	cumba	NN	number=SINGULAR|gender=FEMININE|case=ABLATIVE	
ne	ne	ADV	_	
-c	que	CONJ	_	
pueri	puer	NN	number=PLURAL|gender=MASCULINE|case=NOMINATIVE	
credunt	credo	VB	person=PERSON_3|number=PLURAL|tense=PR|mood=INDICATIVE|voice=ACTIVE	
ni	nisi	CONJ	_	
-si	nisi	CONJ	_	
qui	qui	NN	number=PLURAL|gender=MASCULINE|case=NOMINATIVE	
nondum	nondum	ADV	_	
aere	aer	NN	number=SINGULAR|gender=MASCULINE|case=ABLATIVE	
lavantur	lavo	VB	person=PERSON_3|number=PLURAL|tense=PR|mood=INDICATIVE|voice=PASSIVE	
qualis	qualis	ADJ	number=SINGULAR|gender=MASCULINE|case=NOMINATIVE	
erat	sum	VB	person=PERSON_3|number=SINGULAR|tense=IMP|mood=INDICATIVE|voice=ACTIVE	
nuper	nuper	ADV	_	
tragico	tragicus	ADJ	number=SINGULAR|gender=MASCULINE|case=ABLATIVE	
pollutus	polluo	VB	number=SINGULAR|tense=PERF|mood=PARTICIPLE|voice=PASSIVE|gender=MASCULINE|case=NOMINATIVE	
adulter	adulter	NN	number=SINGULAR|gender=MASCULINE|case=NOMINATIVE	
concubitu	concubitus	NN	number=SINGULAR|gender=MASCULINE|case=ABLATIVE	
qui	qui	PRON	number=SINGULAR|gender=MASCULINE|case=NOMINATIVE	
tunc	tunc	ADV	_	
leges	lex	NN	number=PLURAL|gender=FEMININE|case=ACCUSATIVE	
revocabat	revoco	VB	person=PERSON_3|number=SINGULAR|tense=IMP|mood=INDICATIVE|voice=ACTIVE	
amaras	amarus	ADJ	number=PLURAL|gender=FEMININE|case=ACCUSATIVE	
omnibus	omnis	ADJ	number=PLURAL|gender=MASCULINE|case=DATIVE	
atque	atque	CONJ	_	
ipsis	ipse	PRON	number=PLURAL|gender=MASCULINE|case=DATIVE	
Veneri	Venus	NN	number=SINGULAR|gender=FEMININE|case=DATIVE	
Marti	Mars	NN	number=SINGULAR|gender=MASCULINE|case=DATIVE	
que	que	CONJ	_	
timendas	timeo	VB	number=PLURAL|mood=GERUNDIVE|gender=FEMININE|case=ACCUSATIVE	
cum	Cum	CONJ	_	
tot	tot	ADV	_	
abortivis	abortivus	NN	number=PLURAL|gender=MASCULINE|case=ABLATIVE	
fecundam	fecundus	ADJ	number=SINGULAR|gender=FEMININE|case=ACCUSATIVE	
Iulia	Julius	ADJ	number=SINGULAR|gender=FEMININE|case=NOMINATIVE	
vulvam	volva	NN	number=SINGULAR|gender=FEMININE|case=ACCUSATIVE	
solveret	solvo	VB	person=PERSON_3|number=SINGULAR|tense=IMP|mood=SUBJUNCTIVE|voice=ACTIVE	
et	et	CONJ	_	
patruo	patruus	NN	number=SINGULAR|gender=MASCULINE|case=DATIVE	
similes	similis	ADJ	number=PLURAL|gender=FEMININE|case=ACCUSATIVE	
effunderet	effundo	VB	person=PERSON_3|number=SINGULAR|tense=IMP|mood=SUBJUNCTIVE|voice=ACTIVE	
offas	offa	NN	number=PLURAL|gender=FEMININE|case=ACCUSATIVE	
venerat	venio	VB	person=PERSON_3|number=SINGULAR|tense=PLUSQUAMPERFECT|mood=INDICATIVE|voice=ACTIVE	
obses	obses	NN	number=SINGULAR|gender=MASCULINE|case=NOMINATIVE	
,	comma	CONJ	_	
hic	hic	ADV	_	
fiunt	fio	VB	person=PERSON_3|number=PLURAL|tense=PR|mood=INDICATIVE|voice=ACTIVE	
homines	homo	NN	number=PLURAL|gender=MASCULINE|case=NOMINATIVE	
.	unknown		_	
unde	unde	ADV	_	
haec	hic	ADJ	number=SINGULAR|gender=FEMININE|case=NOMINATIVE	
tetigit	tango	VB	person=PERSON_3|number=SINGULAR|tense=PERF|mood=INDICATIVE|voice=ACTIVE	
Gradive	Gradivus	NN	number=SINGULAR|gender=MASCULINE|case=VOCATIVE	
tuos	tuus	ADJ	number=PLURAL|gender=MASCULINE|case=ACCUSATIVE	
urtica	urtica	NN	number=SINGULAR|gender=FEMININE|case=NOMINATIVE	
nepotes	nepos	NN	number=PLURAL|gender=MASCULINE|case=ACCUSATIVE	
Media	Medius	ADJ	number=SINGULAR|gender=FEMININE|case=NOMINATIVE	
non	non	ADV	_	
lambit	lambo	VB	person=PERSON_3|number=SINGULAR|tense=PR|mood=INDICATIVE|voice=ACTIVE	
Cluviam	Cluvius	ADJ	number=SINGULAR|gender=FEMININE|case=ACCUSATIVE	
ne	ne	ADV	_	
-c	que	CONJ	_	
Flora	Flora	NN	number=SINGULAR|gender=FEMININE|case=NOMINATIVE	
Catullam	Catullus	ADJ	number=SINGULAR|gender=FEMININE|case=ACCUSATIVE	
:	unknown		_	
quae	qui	PRON	number=SINGULAR|gender=FEMININE|case=NOMINATIVE	
causa	causa	NN	number=SINGULAR|gender=FEMININE|case=NOMINATIVE	
officii	officium	NN	number=SINGULAR|gender=NEUTER|case=GENITIVE	
"	unknown		_	
dat	do	VB	person=PERSON_3|number=SINGULAR|tense=PR|mood=INDICATIVE|voice=ACTIVE	
veniam	venia	NN	number=SINGULAR|gender=FEMININE|case=ACCUSATIVE	
corvis	corvus	NN	number=PLURAL|gender=MASCULINE|case=DATIVE	
,	comma	CONJ	_	
vexat	vexo	VB	person=PERSON_3|number=SINGULAR|tense=PR|mood=INDICATIVE|voice=ACTIVE	
censura	censura	NN	number=SINGULAR|gender=FEMININE|case=NOMINATIVE	
columbas	columba	NN	number=PLURAL|gender=FEMININE|case=ACCUSATIVE	
.	unknown		_	
"	unknown		_	
"	unknown		_	
quid	quis	PRON	number=SINGULAR|gender=NEUTER|case=ACCUSATIVE	
quaeris	quaero	VB	person=PERSON_2|number=SINGULAR|tense=PR|mood=INDICATIVE|voice=ACTIVE	
hunc	hic	PRON	number=SINGULAR|gender=MASCULINE|case=ACCUSATIVE	
ego	ego	PRON	number=SINGULAR|gender=MASCULINE|case=NOMINATIVE	
fatis	fatum	NN	number=PLURAL|gender=NEUTER|case=DATIVE	
inputo	imputo	VB	person=PERSON_1|number=SINGULAR|tense=PR|voice=ACTIVE	
qui	qui	PRON	number=SINGULAR|gender=MASCULINE|case=NOMINATIVE	
vultu	vultus	NN	number=SINGULAR|gender=MASCULINE|case=ABLATIVE	
morbum	morbus	NN	number=SINGULAR|gender=MASCULINE|case=ACCUSATIVE	
incessu	incessus	NN	number=SINGULAR|gender=MASCULINE|case=ABLATIVE	
que	que	CONJ	_	
fatetur	fateor	VB	person=PERSON_3|number=SINGULAR|tense=PR|mood=INDICATIVE|voice=PASSIVE	
accipient	accipio	VB	person=PERSON_3|number=PLURAL|tense=FUTURE|mood=INDICATIVE|voice=ACTIVE	
te	tu	PRON	number=SINGULAR|gender=MASCULINE|case=ACCUSATIVE	
paulatim	paulatim	ADV	_	
qui	qui	PRON	number=PLURAL|gender=MASCULINE|case=NOMINATIVE	
longa	longus	ADJ	number=PLURAL|gender=NEUTER|case=ACCUSATIVE	
domi	domus	NN	number=SINGULAR|gender=FEMININE|case=LOCATIVE	
redimicula	redimiculum	NN	number=PLURAL|gender=NEUTER|case=ACCUSATIVE	
sumunt	sumo	VB	person=PERSON_3|number=PLURAL|tense=PR|mood=INDICATIVE|voice=ACTIVE	
frontibus	frons	NN	number=PLURAL|gender=FEMININE|case=ABLATIVE	
et	et	CONJ	_	
toto	totus	ADJ	number=SINGULAR|gender=NEUTER|case=ABLATIVE	
posuere	pono	VB	person=PERSON_3|number=PLURAL|tense=PERF|mood=INDICATIVE|voice=ACTIVE	
monilia	monile	NN	number=PLURAL|gender=NEUTER|case=ACCUSATIVE	
collo	collum	NN	number=SINGULAR|gender=NEUTER|case=ABLATIVE	
atque	atque	CONJ	_	
bonam	bonus	ADJ	number=SINGULAR|gender=FEMININE|case=ACCUSATIVE	
tenerae	tener	ADJ	number=SINGULAR|gender=FEMININE|case=GENITIVE	
placant	placo	VB	person=PERSON_3|number=PLURAL|tense=PR|mood=INDICATIVE|voice=ACTIVE	
abdomine	abdomen	NN	number=SINGULAR|gender=NEUTER|case=ABLATIVE	
porcae	porca	NN	number=SINGULAR|gender=FEMININE|case=GENITIVE	
et	et	CONJ	_	
magno	magnus	ADJ	number=SINGULAR|gender=MASCULINE|case=ABLATIVE	
cratere	crater	NN	number=SINGULAR|gender=MASCULINE|case=ABLATIVE	
deam	dea	NN	number=SINGULAR|gender=FEMININE|case=ACCUSATIVE	
sed	sed	CONJ	_	
more	mos	NN	number=SINGULAR|gender=MASCULINE|case=ABLATIVE	
sinistro	sinister	ADJ	number=SINGULAR|gender=MASCULINE|case=ABLATIVE	
exagitata	exagito	VB	number=SINGULAR|tense=PERF|mood=PARTICIPLE|voice=PASSIVE|gender=FEMININE|case=NOMINATIVE	
procul	procul	ADV	_	
non	non	ADV	_	
intrat	intro	VB	person=PERSON_3|number=SINGULAR|tense=PR|mood=INDICATIVE|voice=ACTIVE	
femina	femina	NN	number=SINGULAR|gender=FEMININE|case=NOMINATIVE	
limen	limen	NN	number=SINGULAR|gender=NEUTER|case=ACCUSATIVE	
indocti	indoctus	ADJ	number=PLURAL|gender=MASCULINE|case=NOMINATIVE	
primum	primus	ADJ	number=SINGULAR|gender=NEUTER|case=ACCUSATIVE	
quamquam	quamquam	CONJ	_	
plena	plenus	ADJ	number=PLURAL|gender=NEUTER|case=ACCUSATIVE	
omnia	omnis	ADJ	number=PLURAL|gender=NEUTER|case=ACCUSATIVE	
gypso	gypsum	NN	number=SINGULAR|gender=NEUTER|case=ABLATIVE	
Chrysippi	Chrysippus	NN	number=SINGULAR|gender=MASCULINE|case=GENITIVE	
invenias	invenio	VB	person=PERSON_2|number=SINGULAR|tense=PR|mood=SUBJUNCTIVE|voice=ACTIVE	
"	unknown		_	
ite	eo	VB	person=PERSON_2|number=PLURAL|tense=PR|mood=IMPERATIVE|voice=ACTIVE	
profanae	profanus	ADJ	number=PLURAL|gender=FEMININE|case=VOCATIVE	
,	unknown		_	
clamatur	clamo	VB	person=PERSON_3|number=SINGULAR|tense=PR|voice=PASSIVE	
"	unknown		_	
,	unknown		_	
"	unknown		_	
nullo	nullus	ADJ	number=SINGULAR|gender=NEUTER|case=ABLATIVE	
gemit	gemo	VB	person=PERSON_3|number=SINGULAR|tense=PR|mood=INDICATIVE|voice=ACTIVE	
hic	hic	ADV	_	
tibicina	tibicina	NN	number=SINGULAR|gender=FEMININE|case=NOMINATIVE	
cornu	cornu	NN	number=SINGULAR|gender=NEUTER|case=ABLATIVE	
.	unknown		_	
"	unknown		_	
dedit	do	VB	person=PERSON_3|number=SINGULAR|tense=PERF|mood=INDICATIVE|voice=ACTIVE	
hanc	hic	PRON	number=SINGULAR|gender=FEMININE|case=ACCUSATIVE	
contagio	contagio	NN	number=SINGULAR|gender=FEMININE|case=NOMINATIVE	
labem	labes	NN	number=SINGULAR|gender=FEMININE|case=ACCUSATIVE	
et	et	CONJ	_	
dabit	do	VB	person=PERSON_3|number=SINGULAR|tense=FUTURE|mood=INDICATIVE|voice=ACTIVE	
in	in	PREP	_	
plures	multus	ADJ	number=PLURAL|gender=MASCULINE|case=ACCUSATIVE	
sicut	sicut	ADV	_	
grex	grex	NN	number=SINGULAR|gender=MASCULINE|case=NOMINATIVE	
totus	totus	ADJ	number=SINGULAR|gender=MASCULINE|case=NOMINATIVE	
in	in	PREP	_	
agris	ager	NN	number=PLURAL|gender=MASCULINE|case=ABLATIVE	
unius	unus	ADJ	number=SINGULAR|gender=MASCULINE|case=GENITIVE	
scabie	scabies	NN	number=SINGULAR|gender=FEMININE|case=ABLATIVE	
cadit	cado	VB	person=PERSON_3|number=SINGULAR|tense=PR|mood=INDICATIVE|voice=ACTIVE	
et	et	CONJ	_	
porrigine	porrigo	NN	number=SINGULAR|gender=FEMININE|case=ABLATIVE	
porci	porcus	NN	number=SINGULAR|gender=MASCULINE|case=GENITIVE	
uva	uva	NN	number=SINGULAR|gender=FEMININE|case=NOMINATIVE	
que	que	CONJ	_	
conspecta	conspicio	VB	number=SINGULAR|tense=PERF|mood=PARTICIPLE|voice=PASSIVE|gender=FEMININE|case=ABLATIVE	
livorem	livor	NN	number=SINGULAR|gender=MASCULINE|case=ACCUSATIVE	
ducit	duco	VB	person=PERSON_3|number=SINGULAR|tense=PR|mood=INDICATIVE|voice=ACTIVE	
ab	ab	PREP	_	
uva	uva	NN	number=SINGULAR|gender=FEMININE|case=ABLATIVE	
donant	dono	VB	person=PERSON_3|number=PLURAL|tense=PR|mood=INDICATIVE|voice=ACTIVE	
arcana	arcanus	ADJ	number=PLURAL|gender=NEUTER|case=NOMINATIVE	
cylindros	cylindrus	NN	number=PLURAL|gender=MASCULINE|case=ACCUSATIVE	
arma	arma	NN	number=PLURAL|gender=NEUTER|case=ACCUSATIVE	
quidem	quidem	ADV	_	
ultra	ultra	ADV	_	
litora	litus	NN	number=PLURAL|gender=NEUTER|case=ACCUSATIVE	
Iuvernae	Iuverna	NN	number=SINGULAR|gender=FEMININE|case=GENITIVE	
promovimus	promoveo	VB	person=PERSON_1|number=PLURAL|tense=PERF|mood=INDICATIVE|voice=ACTIVE	
et	et	CONJ	_	
modo	modo	ADV	_	
captas	capio	VB	number=PLURAL|tense=PERF|mood=PARTICIPLE|voice=PASSIVE|gender=FEMININE|case=ACCUSATIVE	
Orcadas	Orcades	NN	number=PLURAL|gender=FEMININE|case=ACCUSATIVE	
ac	atque	CONJ	_	
minima	minimus	ADJ	number=SINGULAR|gender=FEMININE|case=ABLATIVE	
contentos	contineo	VB	number=PLURAL|tense=PERF|mood=PARTICIPLE|voice=PASSIVE|gender=MASCULINE|case=ACCUSATIVE	
nocte	nox	NN	number=SINGULAR|gender=FEMININE|case=ABLATIVE	
Britannos	Britannus	ADJ	number=PLURAL|gender=MASCULINE|case=ACCUSATIVE	
sed	sed	CONJ	_	
quae	qui	PRON	number=PLURAL|gender=NEUTER|case=NOMINATIVE	
nunc	nunc	ADV	_	
populi	populus	NN	number=SINGULAR|gender=MASCULINE|case=GENITIVE	
fiunt	fio	VB	person=PERSON_3|number=PLURAL|tense=PR|mood=INDICATIVE|voice=ACTIVE	
victoris	victor	NN	number=SINGULAR|gender=MASCULINE|case=GENITIVE	
in	in	PREP	_	
urbe	urbs	NN	number=SINGULAR|gender=FEMININE|case=ABLATIVE	
non	non	ADV	_	
faciunt	facio	VB	person=PERSON_3|number=PLURAL|tense=PR|mood=INDICATIVE|voice=ACTIVE	
illi	ille	PRON	number=PLURAL|gender=MASCULINE|case=NOMINATIVE	
quos	qui	PRON	number=PLURAL|gender=MASCULINE|case=ACCUSATIVE	
vicimus	vinco	VB	person=PERSON_1|number=PLURAL|tense=PERF|mood=INDICATIVE|voice=ACTIVE	
.	unknown		_	
verius	verus	ADV	degree=COMPARATIVE	
ergo	ergo	ADV	_	
et	et	CONJ	_	
magis	magnus	ADV	degree=COMPARATIVE	
ingenue	ingenuus	ADV	_	
Peribomius	Peribomius	NN	number=SINGULAR|gender=MASCULINE|case=NOMINATIVE	
nam	nam	ADV	_	
si	si	CONJ	_	
mora	mora	NN	number=SINGULAR|gender=FEMININE|case=NOMINATIVE	
longior	longus	ADJ	number=SINGULAR|gender=FEMININE|case=NOMINATIVE|degree=COMPARATIVE	
urbem	urbs	NN	number=SINGULAR|gender=FEMININE|case=ACCUSATIVE	
indulsit	indulgeo	VB	person=PERSON_3|number=SINGULAR|tense=PERF|mood=INDICATIVE|voice=ACTIVE	
pueris	puer	NN	number=PLURAL|gender=MASCULINE|case=DATIVE	
non	non	ADV	_	
umquam	umquam	ADV	_	
derit	defleo	VB	person=PERSON_3|number=SINGULAR|tense=PERF|mood=SUBJUNCTIVE|voice=ACTIVE	
amator	amator	NN	number=SINGULAR|gender=MASCULINE|case=NOMINATIVE	
,	comma	CONJ	_	
mittentur	mitto	VB	person=PERSON_3|number=PLURAL|tense=FUTURE|mood=INDICATIVE|voice=PASSIVE	
bracae	braca	NN	number=PLURAL|gender=FEMININE|case=NOMINATIVE	
cultelli	cultellus	NN	number=PLURAL|gender=MASCULINE|case=NOMINATIVE	
frena	frenum	NN	number=PLURAL|gender=NEUTER|case=NOMINATIVE	
flagellum	flagellum	NN	number=SINGULAR|gender=NEUTER|case=NOMINATIVE	
nimirum	nimirum	ADV	_	
summi	summus	ADJ	number=SINGULAR|gender=MASCULINE|case=GENITIVE	
ducis	dux	NN	number=SINGULAR|gender=MASCULINE|case=GENITIVE	
est	sum	VB	person=PERSON_3|number=SINGULAR|tense=PR|mood=INDICATIVE|voice=ACTIVE	
occidere	occido	VB	tense=PR|mood=INFINITIVE|voice=ACTIVE	
Galbam	Galba	NN	number=SINGULAR|gender=MASCULINE|case=ACCUSATIVE	
et	et	CONJ	_	
curare	curo	VB	tense=PR|mood=INFINITIVE|voice=ACTIVE	
cutem	cutis	NN	number=SINGULAR|gender=FEMININE|case=ACCUSATIVE	
nam	nam	CONJ	_	
perfectissimus	perficio	VB	number=SINGULAR|tense=PERF|mood=PARTICIPLE|voice=PASSIVE|gender=MASCULINE|case=NOMINATIVE|degree=SUPERLATIVE	
horum	hic	PRON	number=PLURAL|gender=MASCULINE|case=GENITIVE	
si	si	CONJ	_	
quis	aliquis	PRON	number=SINGULAR|gender=MASCULINE|case=NOMINATIVE	
Aristotelen	Aristoteles	NN	number=SINGULAR|gender=MASCULINE|case=ACCUSATIVE	
similem	similis	ADJ	number=SINGULAR|gender=MASCULINE|case=ACCUSATIVE	
vel	vel	CONJ	_	
Pittacon	Pittacus	NN	number=SINGULAR|gender=MASCULINE|case=ACCUSATIVE	
emit	emo	VB	person=PERSON_3|number=SINGULAR|tense=PR|mood=INDICATIVE|voice=ACTIVE	
et	et	CONJ	_	
iubet	jubeo	VB	person=PERSON_3|number=SINGULAR|tense=PR|mood=INDICATIVE|voice=ACTIVE	
archetypos	archetypus	ADJ	number=PLURAL|gender=MASCULINE|case=ACCUSATIVE	
pluteum	pluteus	NN	number=SINGULAR|gender=MASCULINE|case=ACCUSATIVE	
servare	servo	VB	tense=PR|mood=INFINITIVE|voice=ACTIVE	
Cleanthas	Cleanthes	NN	number=PLURAL|gender=MASCULINE|case=ACCUSATIVE	
horum	hic	PRON	number=PLURAL|gender=MASCULINE|case=GENITIVE	
simplicitas	simplicitas	NN	number=SINGULAR|gender=FEMININE|case=NOMINATIVE	
miserabilis	miserabilis	ADJ	number=SINGULAR|gender=FEMININE|case=NOMINATIVE	
,	comma	CONJ	_	
his	hic	PRON	number=PLURAL|gender=MASCULINE|case=DATIVE	
furor	furor	NN	number=SINGULAR|gender=MASCULINE|case=NOMINATIVE	
ipse	ipse	PRON	number=SINGULAR|gender=MASCULINE|case=NOMINATIVE	
dat	do	VB	person=PERSON_3|number=SINGULAR|tense=PR|mood=INDICATIVE|voice=ACTIVE	
veniam	venia	NN	number=SINGULAR|gender=FEMININE|case=ACCUSATIVE	
minus	parvus	ADV	degree=COMPARATIVE	
est	sum	VB	person=PERSON_3|number=SINGULAR|tense=PR|mood=INDICATIVE|voice=ACTIVE	
insania	insania	NN	number=SINGULAR|gender=FEMININE|case=NOMINATIVE	
turpis	turpis	ADJ	number=SINGULAR|gender=FEMININE|case=NOMINATIVE	
.	unknown		_	
quis	quis	PRON	number=SINGULAR|gender=MASCULINE|case=NOMINATIVE	
caelum	caelum	NN	number=SINGULAR|gender=NEUTER|case=ACCUSATIVE	
terris	terra	NN	number=PLURAL|gender=FEMININE|case=ABLATIVE	
non	non	ADV	_	
misceat	misceo	VB	person=PERSON_3|number=SINGULAR|tense=PR|mood=SUBJUNCTIVE|voice=ACTIVE	
et	et	CONJ	_	
mare	mare	NN	number=SINGULAR|gender=NEUTER|case=ACCUSATIVE	
caelo	caelum	NN	number=SINGULAR|gender=NEUTER|case=ABLATIVE	
si	si	CONJ	_	
fur	fur	NN	number=SINGULAR|gender=MASCULINE|case=NOMINATIVE	
displiceat	displiceo	VB	person=PERSON_3|number=SINGULAR|tense=PR|mood=SUBJUNCTIVE|voice=ACTIVE	
Verri	Verres	NN	number=SINGULAR|gender=MASCULINE|case=DATIVE	
,	comma	CONJ	_	
homicida	homicida	NN	number=SINGULAR|gender=MASCULINE|case=NOMINATIVE	
Miloni	Milo	NN	number=SINGULAR|gender=MASCULINE|case=DATIVE	
,	comma	CONJ	_	
Clodius	Clodius	NN	number=SINGULAR|gender=MASCULINE|case=NOMINATIVE	
accuset	accuso	VB	person=PERSON_3|number=SINGULAR|tense=PR|mood=SUBJUNCTIVE|voice=ACTIVE	
moechos	moechus	NN	number=PLURAL|gender=MASCULINE|case=ACCUSATIVE	
,	comma	CONJ	_	
Catilina	Catilina	NN	number=SINGULAR|gender=MASCULINE|case=NOMINATIVE	
Cethegum	Cethegus	NN	number=SINGULAR|gender=MASCULINE|case=ACCUSATIVE	
,	comma	CONJ	_	
in	in	PREP	_	
tabulam	tabula	NN	number=SINGULAR|gender=FEMININE|case=ACCUSATIVE	
Syllae	Sulla	NN	number=SINGULAR|gender=MASCULINE|case=GENITIVE	
si	si	CONJ	_	
dicant	dico	VB	person=PERSON_3|number=PLURAL|tense=PR|mood=SUBJUNCTIVE|voice=ACTIVE	
discipuli	discipulus	NN	number=PLURAL|gender=MASCULINE|case=NOMINATIVE	
tres	tres	NRL	_	
acer	acer	ADJ	number=SINGULAR|gender=MASCULINE|case=NOMINATIVE	
et	et	CONJ	_	
indomitus	indomitus	ADJ	number=SINGULAR|gender=MASCULINE|case=NOMINATIVE	
libertatis	libertas	NN	number=SINGULAR|gender=FEMININE|case=GENITIVE	
que	que	CONJ	_	
magister	magister	NN	number=SINGULAR|gender=MASCULINE|case=NOMINATIVE	
Cretice	Creticus	ADJ	number=SINGULAR|gender=MASCULINE|case=VOCATIVE	
perluces	perluceo	VB	person=PERSON_2|number=SINGULAR|tense=PR|mood=INDICATIVE|voice=ACTIVE	
quis	quis	PRON	number=SINGULAR|gender=MASCULINE|case=NOMINATIVE	
enim	enim	ADV	_	
non	non	ADV	_	
vicus	vicus	NN	number=SINGULAR|gender=MASCULINE|case=NOMINATIVE	
abundat	abundo	VB	person=PERSON_3|number=SINGULAR|tense=PR|mood=INDICATIVE|voice=ACTIVE	
tristibus	tristis	ADJ	number=PLURAL|gender=MASCULINE|case=ABLATIVE	
obscaenis	obscaenus	ADJ	number=PLURAL|gender=MASCULINE|case=ABLATIVE	
quis	quis	PRON	number=SINGULAR|gender=MASCULINE|case=NOMINATIVE	
tulerit	fero	VB	person=PERSON_3|number=SINGULAR|tense=PERF|mood=SUBJUNCTIVE|voice=ACTIVE	
Gracchos	Gracchus	NN	number=PLURAL|gender=MASCULINE|case=ACCUSATIVE	
de	de	PREP	_	
seditione	seditio	NN	number=SINGULAR|gender=FEMININE|case=ABLATIVE	
querentes	queror	VB	number=PLURAL|tense=PR|mood=PARTICIPLE|gender=MASCULINE|case=ACCUSATIVE	
Hispo	Hispo	NN	number=SINGULAR|gender=MASCULINE|case=NOMINATIVE	
subit	subeo	VB	person=PERSON_3|number=SINGULAR|tense=PR|mood=INDICATIVE|voice=ACTIVE	
iuvenes	juvenis	ADJ	number=PLURAL|gender=MASCULINE|case=ACCUSATIVE	
et	et	CONJ	_	
morbo	morbus	NN	number=SINGULAR|gender=MASCULINE|case=ABLATIVE	
pallet	palleo	VB	person=PERSON_3|number=SINGULAR|tense=PR|mood=INDICATIVE|voice=ACTIVE	
utroque	uterque	PRON	number=SINGULAR|gender=MASCULINE|case=ABLATIVE	
notum	notus	ADJ	number=SINGULAR|gender=NEUTER|case=NOMINATIVE	
est	sum	VB	person=PERSON_3|number=SINGULAR|tense=PR|mood=INDICATIVE|voice=ACTIVE	
cur	cur	ADV	_	
solo	solus	ADJ	number=SINGULAR|gender=MASCULINE|case=ABLATIVE	
tabulas	tabula	NN	number=PLURAL|gender=FEMININE|case=ACCUSATIVE	
inpleverit	inpleo	VB	person=PERSON_3|number=SINGULAR|tense=PERF|mood=SUBJUNCTIVE|voice=ACTIVE	
Hister	Hister	NN	number=SINGULAR|gender=MASCULINE|case=NOMINATIVE	
liberto	libertus	ADJ	number=SINGULAR|gender=MASCULINE|case=ABLATIVE	
,	comma	CONJ	_	
dederit	do	VB	person=PERSON_3|number=SINGULAR|tense=PERF|mood=SUBJUNCTIVE|voice=ACTIVE	
vivus	vivus	ADJ	number=SINGULAR|gender=MASCULINE|case=NOMINATIVE	
cur	cur	ADV	_	
multa	multus	ADJ	number=PLURAL|gender=NEUTER|case=ACCUSATIVE	
puellae	puella	NN	number=SINGULAR|gender=FEMININE|case=DATIVE	
ille	ille	PRON	number=SINGULAR|gender=MASCULINE|case=NOMINATIVE	
tenet	teneo	VB	person=PERSON_3|number=SINGULAR|tense=PR|mood=INDICATIVE|voice=ACTIVE	
speculum	speculum	NN	number=SINGULAR|gender=NEUTER|case=ACCUSATIVE	
pathici	pathicus	ADJ	number=SINGULAR|gender=MASCULINE|case=GENITIVE	
gestamen	gestamen	NN	number=SINGULAR|gender=NEUTER|case=ACCUSATIVE	
Othonis	Otho	NN	number=SINGULAR|gender=MASCULINE|case=GENITIVE	
Actoris	Actor	NN	number=SINGULAR|gender=MASCULINE|case=GENITIVE	
Aurunci	Auruncus	ADJ	number=SINGULAR|gender=MASCULINE|case=GENITIVE	
spolium	spolium	NN	number=SINGULAR|gender=NEUTER|case=ACCUSATIVE	
quo	qui	PRON	number=SINGULAR|gender=NEUTER|case=ABLATIVE	
se	sui	PRON	number=SINGULAR|gender=MASCULINE|case=ACCUSATIVE	
ille	ille	PRON	number=SINGULAR|gender=MASCULINE|case=NOMINATIVE	
videbat	video	VB	person=PERSON_3|number=SINGULAR|tense=IMP|mood=INDICATIVE|voice=ACTIVE	
armatum	armatus	NN	number=SINGULAR|gender=MASCULINE|case=ACCUSATIVE	
cum	Cum	CONJ	_	
iam	jam	ADV	_	
tolli	tollo	VB	tense=PR|mood=INFINITIVE|voice=PASSIVE	
vexilla	vexillum	NN	number=PLURAL|gender=NEUTER|case=ACCUSATIVE	
iuberet	jubeo	VB	person=PERSON_3|number=SINGULAR|tense=IMP|mood=SUBJUNCTIVE|voice=ACTIVE	
.	unknown		_	
quid	quis	PRON	number=SINGULAR|gender=NEUTER|case=ACCUSATIVE	
tamen	tamen	ADV	_	
expectant	exspecto	VB	person=PERSON_3|number=PLURAL|tense=PR|mood=INDICATIVE|voice=ACTIVE	
Phrygio	Phrygius	ADJ	number=SINGULAR|gender=MASCULINE|case=ABLATIVE	
quos	qui	PRON	number=PLURAL|gender=MASCULINE|case=ACCUSATIVE	
tempus	tempus	NN	number=SINGULAR|gender=NEUTER|case=NOMINATIVE	
erat	sum	VB	person=PERSON_3|number=SINGULAR|tense=IMP|mood=INDICATIVE|voice=ACTIVE	
iam	jam	ADV	_	
more	mos	NN	number=SINGULAR|gender=MASCULINE|case=ABLATIVE	
supervacuam	supervacuus	ADJ	number=SINGULAR|gender=FEMININE|case=ACCUSATIVE	
cultris	culter	NN	number=PLURAL|gender=MASCULINE|case=ABLATIVE	
abrumpere	abrumpo	VB	tense=PR|mood=INFINITIVE|voice=ACTIVE	
carnem	caro	NN	number=SINGULAR|gender=FEMININE|case=ACCUSATIVE	
talem	talis	ADJ	number=SINGULAR|gender=FEMININE|case=ACCUSATIVE	
non	non	ADV	_	
sumet	sumo	VB	person=PERSON_3|number=SINGULAR|tense=FUTURE|mood=INDICATIVE|voice=ACTIVE	
damnata	damno	VB	number=SINGULAR|tense=PERF|mood=PARTICIPLE|voice=PASSIVE|gender=FEMININE|case=NOMINATIVE	
togam	toga	NN	number=SINGULAR|gender=FEMININE|case=ACCUSATIVE	
.	unknown		_	
"	unknown		_	
rarus	rarus	ADJ	number=SINGULAR|gender=MASCULINE|case=NOMINATIVE	
sermo	sermo	NN	number=SINGULAR|gender=MASCULINE|case=NOMINATIVE	
illis	ille	PRON	number=PLURAL|gender=MASCULINE|case=DATIVE	
et	et	CONJ	_	
magna	magnus	ADJ	number=SINGULAR|gender=FEMININE|case=NOMINATIVE	
libido	libido	NN	number=SINGULAR|gender=FEMININE|case=NOMINATIVE	
tacendi	taceo	VB	number=SINGULAR|tense=PR|mood=GERUND|voice=ACTIVE|case=GENITIVE	
atque	atque	CONJ	_	
supercilio	supercilium	NN	number=SINGULAR|gender=NEUTER|case=ABLATIVE	
brevior	brevis	ADJ	number=SINGULAR|gender=FEMININE|case=NOMINATIVE|degree=COMPARATIVE	
coma	coma	NN	number=SINGULAR|gender=FEMININE|case=NOMINATIVE	
et	et	CONJ	_	
tamen	tamen	ADV	_	
unus	unus	ADJ	number=SINGULAR|gender=MASCULINE|case=NOMINATIVE	
Armenius	Arminius	NN	number=SINGULAR|gender=MASCULINE|case=NOMINATIVE	
Zalaces	Zalaces	NN	number=SINGULAR|gender=MASCULINE|case=NOMINATIVE	
cunctis	cunctus	ADJ	number=PLURAL|gender=MASCULINE|case=ABLATIVE	
narratur	narro	VB	person=PERSON_3|number=SINGULAR|tense=PR|mood=INDICATIVE|voice=PASSIVE	
ephebis	ephebus	NN	number=PLURAL|gender=MASCULINE|case=ABLATIVE	
mollior	mollis	ADJ	number=SINGULAR|gender=MASCULINE|case=NOMINATIVE|degree=COMPARATIVE	
ardenti	ardeo	VB	number=SINGULAR|tense=PR|mood=PARTICIPLE|gender=MASCULINE|case=DATIVE	
sese	sui	PRON	number=SINGULAR|gender=MASCULINE|case=ACCUSATIVE	
indulsisse	indulgeo	VB	tense=PERF|mood=INFINITIVE|voice=ACTIVE	
tribuno	tribunus	NN	number=SINGULAR|gender=MASCULINE|case=DATIVE	
summi	summus	ADJ	number=SINGULAR|gender=MASCULINE|case=GENITIVE	
constantia	constantia	NN	number=SINGULAR|gender=FEMININE|case=NOMINATIVE	
civis	civis	NN	number=SINGULAR|gender=MASCULINE|case=GENITIVE	
Bebriacis	Bebriacus	ADJ	number=PLURAL|gender=MASCULINE|case=ABLATIVE	
campis	campus	NN	number=PLURAL|gender=MASCULINE|case=ABLATIVE	
spolium	spolium	NN	number=SINGULAR|gender=NEUTER|case=ACCUSATIVE	
adfectare	affecto	VB	tense=PR|mood=INFINITIVE|voice=ACTIVE	
Palati	Palatium	NN	number=SINGULAR|gender=NEUTER|case=GENITIVE	
et	et	CONJ	_	
pressum	premo	VB	number=SINGULAR|tense=PERF|mood=PARTICIPLE|voice=PASSIVE|gender=MASCULINE|case=ACCUSATIVE	
in	in	PREP	_	
faciem	facies	NN	number=SINGULAR|gender=FEMININE|case=ACCUSATIVE	
digitis	digitus	NN	number=PLURAL|gender=MASCULINE|case=ABLATIVE	
extendere	extendo	VB	tense=PR|mood=INFINITIVE|voice=ACTIVE	
panem	panis	NN	number=SINGULAR|gender=MASCULINE|case=ACCUSATIVE	
quod	qui	PRON	number=SINGULAR|gender=NEUTER|case=ACCUSATIVE	
ne	ne	ADV	_	
-c	que	CONJ	_	
in	in	PREP	_	
Assyrio	Assyrius	ADJ	number=SINGULAR|gender=MASCULINE|case=ABLATIVE	
pharetrata	pharetratus	ADJ	number=SINGULAR|gender=FEMININE|case=NOMINATIVE	
Samiramis	Samiramis	NN	number=SINGULAR|gender=FEMININE|case=NOMINATIVE	
orbe	orbis	NN	number=SINGULAR|gender=MASCULINE|case=ABLATIVE	
maesta	maestus	ADJ	number=SINGULAR|gender=FEMININE|case=NOMINATIVE	
ne	ne	ADV	_	
-c	que	CONJ	_	
Actiaca	Actiacus	ADJ	number=SINGULAR|gender=FEMININE|case=ABLATIVE	
fecit	facio	VB	person=PERSON_3|number=SINGULAR|tense=PERF|mood=INDICATIVE|voice=ACTIVE	
Cleopatra	Cleopatra	NN	number=SINGULAR|gender=FEMININE|case=NOMINATIVE	
carina	carina	NN	number=SINGULAR|gender=FEMININE|case=ABLATIVE	
.	unknown		_	
loripedem	loripes	NN	number=SINGULAR|gender=MASCULINE|case=ACCUSATIVE	
rectus	rectus	ADJ	number=SINGULAR|gender=MASCULINE|case=NOMINATIVE	
derideat	derideo	VB	person=PERSON_3|number=SINGULAR|tense=PR|mood=SUBJUNCTIVE|voice=ACTIVE	
,	comma	CONJ	_	
Aethiopem	Aethiops	NN	number=SINGULAR|gender=MASCULINE|case=ACCUSATIVE	
albus	albus	ADJ	number=SINGULAR|gender=MASCULINE|case=NOMINATIVE	
Curius	Curius	ADJ	number=SINGULAR|gender=MASCULINE|case=NOMINATIVE	
quid	quis	PRON	number=SINGULAR|gender=NEUTER|case=ACCUSATIVE	
sentit	sentio	VB	person=PERSON_3|number=SINGULAR|tense=PR|mood=INDICATIVE|voice=ACTIVE	
et	et	CONJ	_	
ambo	ambo	NRL	number=PLURAL|gender=MASCULINE	
Scipiadae	Scipiades	NN	number=PLURAL|gender=MASCULINE|case=NOMINATIVE	
quid	quis	PRON	number=SINGULAR|gender=NEUTER|case=ACCUSATIVE	
Fabricius	Fabricius	ADJ	number=SINGULAR|gender=MASCULINE|case=NOMINATIVE	
manes	Manes	NN	number=PLURAL|gender=MASCULINE|case=NOMINATIVE	
que	que	CONJ	_	
Camilli	Camillus	NN	number=SINGULAR|gender=MASCULINE|case=GENITIVE	
quid	quis	PRON	number=SINGULAR|gender=NEUTER|case=ACCUSATIVE	
Cremerae	Cremera	NN	number=SINGULAR|gender=FEMININE|case=GENITIVE	
legio	legio	NN	number=SINGULAR|gender=FEMININE|case=NOMINATIVE	
et	et	CONJ	_	
Cannis	Cannae	NN	number=PLURAL|gender=FEMININE|case=LOCATIVE	
consumpta	consumo	VB	number=SINGULAR|tense=PERF|mood=PARTICIPLE|voice=PASSIVE|gender=FEMININE|case=NOMINATIVE	
iuventus	juventus	NN	number=SINGULAR|gender=FEMININE|case=NOMINATIVE	
tot	tot	ADV	_	
bellorum	bellum	NN	number=PLURAL|gender=NEUTER|case=GENITIVE	
animae	anima	NN	number=PLURAL|gender=FEMININE|case=NOMINATIVE	
quotiens	quotiens	ADV	_	
hinc	hinc	ADV	_	
talis	talis	ADJ	number=SINGULAR|gender=FEMININE|case=NOMINATIVE	
ad	ad	PREP	_	
illos	ille	PRON	number=PLURAL|gender=MASCULINE|case=ACCUSATIVE	
umbra	umbra	NN	number=SINGULAR|gender=FEMININE|case=NOMINATIVE	
venit	venio	VB	person=PERSON_3|number=SINGULAR|tense=PR|mood=INDICATIVE|voice=ACTIVE	
atque	atque	CONJ	_	
ita	ita	ADV	_	
subridens	subrideo	VB	number=SINGULAR|tense=PR|mood=PARTICIPLE|gender=FEMININE|case=NOMINATIVE	
:	unknown		_	
"	unknown		_	
felicia	felix	ADJ	number=PLURAL|gender=NEUTER|case=NOMINATIVE	
tempora	tempus	NN	number=PLURAL|gender=NEUTER|case=NOMINATIVE	
quae	qui	PRON	number=PLURAL|gender=NEUTER|case=NOMINATIVE	
te	tu	PRON	number=SINGULAR|gender=MASCULINE|case=ACCUSATIVE	
moribus	mos	NN	number=PLURAL|gender=MASCULINE|case=DATIVE	
opponunt	oppono	VB	person=PERSON_3|number=PLURAL|tense=PR|mood=INDICATIVE|voice=ACTIVE	
non	non	ADV	_	
erit	sum	VB	person=PERSON_3|number=SINGULAR|tense=FUTURE|mood=INDICATIVE|voice=ACTIVE	
ullum	ullus	ADJ	number=SINGULAR|gender=NEUTER|case=NOMINATIVE	
exemplum	exemplum	NN	number=SINGULAR|gender=NEUTER|case=NOMINATIVE	
in	in	PREP	_	
nostro	noster	ADJ	number=SINGULAR|gender=MASCULINE|case=ABLATIVE	
tam	tam	ADV	_	
detestabile	detestabilis	ADJ	number=SINGULAR|gender=NEUTER|case=NOMINATIVE	
sexu	sexus	NN	number=SINGULAR|gender=MASCULINE|case=ABLATIVE	
illic	illic	ADV	_	
heu	heu	EXCL	_	
miseri	miser	ADJ	number=PLURAL|gender=MASCULINE|case=NOMINATIVE	
traducimur	traduco	VB	person=PERSON_1|number=PLURAL|tense=PR|mood=INDICATIVE|voice=PASSIVE	
o	O	EXCL	_	
proceres	procer	NN	number=PLURAL|gender=MASCULINE|case=VOCATIVE	
censore	censor	NN	number=SINGULAR|gender=MASCULINE|case=ABLATIVE	
opus	opus	NN	number=SINGULAR|gender=NEUTER|case=NOMINATIVE	
est	sum	VB	person=PERSON_3|number=SINGULAR|tense=PR|mood=INDICATIVE|voice=ACTIVE	
an	an	CONJ	_	
haruspice	haruspex	NN	number=SINGULAR|gender=MASCULINE|case=ABLATIVE	
nobis	nos	PRON	number=PLURAL|gender=MASCULINE|case=DATIVE	
Fugerunt	fugio	VB	person=PERSON_3|number=PLURAL|tense=PERF|mood=INDICATIVE|voice=ACTIVE	
trepidi	trepidus	ADJ	number=PLURAL|gender=MASCULINE|case=NOMINATIVE	
vera	verus	ADJ	number=PLURAL|gender=NEUTER|case=ACCUSATIVE	
ac	atque	CONJ	_	
manifesta	manifesto	VB	person=PERSON_2|number=SINGULAR|tense=PR|mood=IMPERATIVE|voice=ACTIVE	
canentem	caneo	VB	number=SINGULAR|tense=PR|mood=PARTICIPLE|gender=FEMININE|case=ACCUSATIVE	
Stoicidae	Stoicida	NN	number=PLURAL|gender=MASCULINE|case=NOMINATIVE	
interea	interea	ADV	_	
tormentum	tormentum	NN	number=SINGULAR|gender=NEUTER|case=NOMINATIVE	
ingens	ingens	ADJ	number=SINGULAR|gender=NEUTER|case=NOMINATIVE	
nubentibus	nubo	VB	number=PLURAL|tense=PR|mood=PARTICIPLE|gender=MASCULINE|case=DATIVE	
haeret	haereo	VB	person=PERSON_3|number=SINGULAR|tense=PR|mood=INDICATIVE|voice=ACTIVE	
quod	quod	CONJ	_	
nequeant	nequeo	VB	person=PERSON_3|number=PLURAL|tense=PR|mood=SUBJUNCTIVE|voice=ACTIVE	
parere	pario	VB	tense=PR|mood=INFINITIVE|voice=ACTIVE	
et	et	CONJ	_	
partu	partus	NN	number=SINGULAR|gender=MASCULINE|case=ABLATIVE	
retinere	retineo	VB	tense=PR|mood=INFINITIVE|voice=ACTIVE	
maritos	maritus	NN	number=PLURAL|gender=MASCULINE|case=ACCUSATIVE	
.	unknown		_	
respice	respicio	VB	person=PERSON_2|number=SINGULAR|tense=PR|mood=IMPERATIVE|voice=ACTIVE	
primum	primus	ADJ	number=SINGULAR|gender=NEUTER|case=ACCUSATIVE	
et	et	CONJ	_	
scrutare	scrutor	VB	person=PERSON_2|number=SINGULAR|tense=PR|mood=IMPERATIVE|voice=PASSIVE	
viros	vir	NN	number=PLURAL|gender=MASCULINE|case=ACCUSATIVE	
vos	tu	PRON	number=PLURAL|gender=MASCULINE|case=NOMINATIVE	
lanam	lana	NN	number=SINGULAR|gender=FEMININE|case=ACCUSATIVE	
trahitis	traho	VB	person=PERSON_2|number=PLURAL|tense=PR|mood=INDICATIVE|voice=ACTIVE	
calathis	calathus	NN	number=PLURAL|gender=MASCULINE|case=ABLATIVE	
que	que	CONJ	_	
peracta	perago	VB	number=PLURAL|tense=PERF|mood=PARTICIPLE|voice=PASSIVE|gender=NEUTER|case=ACCUSATIVE	
refertis	refero	VB	person=PERSON_2|number=PLURAL|tense=PR|mood=INDICATIVE|voice=ACTIVE	
vellera	vellus	NN	number=PLURAL|gender=NEUTER|case=ACCUSATIVE	
,	comma	CONJ	_	
vos	tu	PRON	number=PLURAL|gender=MASCULINE|case=NOMINATIVE	
tenui	tenuis	ADJ	number=SINGULAR|gender=NEUTER|case=ABLATIVE	
praegnantem	praegno	VB	number=SINGULAR|tense=PR|mood=PARTICIPLE|gender=MASCULINE|case=ACCUSATIVE	
stamine	stamen	NN	number=SINGULAR|gender=NEUTER|case=ABLATIVE	
fusum	fusus	NN	number=SINGULAR|gender=MASCULINE|case=ACCUSATIVE	
Penelope	Penelope	NN	number=SINGULAR|gender=FEMININE|case=ABLATIVE	
melius	melius	ADV	_	
,	comma	CONJ	_	
levius	levis	ADV	_	
torquetis	torqueo	VB	person=PERSON_2|number=PLURAL|tense=PR|mood=INDICATIVE|voice=ACTIVE	
Arachne	Arachne	NN	number=SINGULAR|gender=FEMININE|case=ABLATIVE	
horrida	horridus	ADJ	number=SINGULAR|gender=FEMININE|case=NOMINATIVE	
quale	qualis	ADJ	number=SINGULAR|gender=NEUTER|case=ACCUSATIVE	
facit	facio	VB	person=PERSON_3|number=SINGULAR|tense=PR|mood=INDICATIVE|voice=ACTIVE	
residens	resideo	VB	number=SINGULAR|tense=PR|mood=PARTICIPLE|gender=FEMININE|case=NOMINATIVE	
in	in	PREP	_	
codice	codex	NN	number=SINGULAR|gender=MASCULINE|case=ABLATIVE	
paelex	paelex	NN	number=SINGULAR|gender=FEMININE|case=NOMINATIVE	
.	unknown		_	
traditur	trado	VB	person=PERSON_3|number=SINGULAR|tense=PR|mood=INDICATIVE|voice=PASSIVE	
ecce	ecce	EXCL	_	
viro	vir	NN	number=SINGULAR|gender=MASCULINE|case=DATIVE	
clarus	clarus	ADJ	number=SINGULAR|gender=MASCULINE|case=NOMINATIVE	
genere	genus	NN	number=SINGULAR|gender=NEUTER|case=ABLATIVE	
atque	atque	CONJ	_	
opibus	ops	NN	number=PLURAL|gender=FEMININE|case=ABLATIVE	
vir	vir	NN	number=SINGULAR|gender=MASCULINE|case=NOMINATIVE	
ne	ne	ADV	_	
-c	que	CONJ	_	
galeam	galea	NN	number=SINGULAR|gender=FEMININE|case=ACCUSATIVE	
quassas	quasso	VB	person=PERSON_2|number=SINGULAR|tense=PR|mood=INDICATIVE|voice=ACTIVE	
ne	ne	ADV	_	
-c	que	CONJ	_	
terram	terra	NN	number=SINGULAR|gender=FEMININE|case=ACCUSATIVE	
cuspide	cuspis	NN	number=SINGULAR|gender=FEMININE|case=ABLATIVE	
pulsas	pulso	VB	person=PERSON_2|number=SINGULAR|tense=PR|mood=INDICATIVE|voice=ACTIVE	
ne	ne	ADV	_	
-c	que	CONJ	_	
quereris	queror	VB	person=PERSON_2|number=SINGULAR|tense=PR|mood=INDICATIVE|voice=PASSIVE	
patri	pater	NN	number=SINGULAR|gender=MASCULINE|case=DATIVE	
quid	quis	PRON	number=SINGULAR|gender=NEUTER|case=ACCUSATIVE	
non	non	ADV	_	
proclames	proclamo	VB	person=PERSON_2|number=SINGULAR|tense=PR|mood=SUBJUNCTIVE|voice=ACTIVE	
in	in	PREP	_	
corpore	corpus	NN	number=SINGULAR|gender=NEUTER|case=ABLATIVE	
iudicis	judex	NN	number=SINGULAR|gender=MASCULINE|case=GENITIVE	
ista	iste	PRON	number=PLURAL|gender=NEUTER|case=ACCUSATIVE	
si	si	CONJ	_	
videas	video	VB	person=PERSON_2|number=SINGULAR|tense=PR|mood=SUBJUNCTIVE|voice=ACTIVE	
o	O	EXCL	_	
pater	pater	NN	number=SINGULAR|gender=MASCULINE|case=VOCATIVE	
urbis	urbs	NN	number=SINGULAR|gender=FEMININE|case=GENITIVE	
unde	unde	ADV	_	
nefas	nefas	NN	_	
tantum	tantus	ADJ	number=SINGULAR|gender=NEUTER|case=NOMINATIVE	
Latiis	Latius	ADJ	number=PLURAL|gender=MASCULINE|case=DATIVE	
pastoribus	pastor	NN	number=PLURAL|gender=MASCULINE|case=DATIVE	
Non	non	ADV	_	
tulit	fero	VB	person=PERSON_3|number=SINGULAR|tense=PERF|mood=INDICATIVE|voice=ACTIVE	
ex	ex	PREP	_	
illis	ille	PRON	number=PLURAL|gender=MASCULINE|case=ABLATIVE	
torvum	torvus	ADJ	number=SINGULAR|gender=MASCULINE|case=ACCUSATIVE	
Laronia	Laronia	NN	number=SINGULAR|gender=FEMININE|case=NOMINATIVE	
quendam	quidam	PRON	number=SINGULAR|gender=MASCULINE|case=ACCUSATIVE	
clamantem	clamo	VB	number=SINGULAR|tense=PR|mood=PARTICIPLE|gender=MASCULINE|case=ACCUSATIVE	
totiens	totiens	ADV	_	
ubi	ubi	ADV	_	
nunc	nunc	ADV	_	
lex	lex	NN	number=SINGULAR|gender=FEMININE|case=NOMINATIVE	
Iulia	Julius	ADJ	number=SINGULAR|gender=FEMININE|case=NOMINATIVE	
dormis	dormio	VB	person=PERSON_2|number=SINGULAR|tense=PR|mood=INDICATIVE|voice=ACTIVE	
ne	ne	ADV	_	
pudeat	pudeo	VB	person=PERSON_3|number=SINGULAR|tense=PR|mood=SUBJUNCTIVE|voice=ACTIVE	
dominum	dominus	NN	number=SINGULAR|gender=MASCULINE|case=ACCUSATIVE	
monstrare	monstro	VB	tense=PR|mood=INFINITIVE|voice=ACTIVE	
tabernae	taberna	NN	number=SINGULAR|gender=FEMININE|case=GENITIVE	
quod	quod	CONJ	_	
si	si	CONJ	_	
vexantur	vexo	VB	person=PERSON_3|number=PLURAL|tense=PR|mood=INDICATIVE|voice=PASSIVE	
leges	lex	NN	number=PLURAL|gender=FEMININE|case=NOMINATIVE	
ac	atque	CONJ	_	
iura	ius	NN	number=PLURAL|gender=NEUTER|case=NOMINATIVE	
citari	cito	VB	tense=PR|mood=INFINITIVE|voice=PASSIVE	
ante	ante	PREP	_	
omnes	omnis	ADJ	number=PLURAL|gender=FEMININE|case=ACCUSATIVE	
debet	debeo	VB	person=PERSON_3|number=SINGULAR|tense=PR|mood=INDICATIVE|voice=ACTIVE	
Scantinia	Scantinius	ADJ	number=SINGULAR|gender=FEMININE|case=NOMINATIVE	
vade	vado	VB	person=PERSON_2|number=SINGULAR|tense=PR|mood=IMPERATIVE|voice=ACTIVE	
ergo	ergo	ADV	_	
et	et	CONJ	_	
cede	cedo	VB	person=PERSON_2|number=SINGULAR|tense=PR|mood=IMPERATIVE|voice=ACTIVE	
severi	severus	ADJ	number=SINGULAR|gender=MASCULINE|case=GENITIVE	
iugeribus	jugerum	NN	number=PLURAL|gender=NEUTER|case=ABLATIVE	
campi	campus	NN	number=SINGULAR|gender=MASCULINE|case=GENITIVE	
quem	qui	PRON	number=SINGULAR|gender=MASCULINE|case=ACCUSATIVE	
neglegis	neglego	VB	person=PERSON_2|number=SINGULAR|tense=PR|mood=INDICATIVE|voice=ACTIVE	
.	unknown		_	
"	unknown		_	
habeat	habeo	VB	person=PERSON_3|number=SINGULAR|tense=PR|mood=SUBJUNCTIVE|voice=ACTIVE	
iam	jam	ADV	_	
Roma	Roma	NN	number=SINGULAR|gender=FEMININE|case=NOMINATIVE	
pudorem	pudor	NN	number=SINGULAR|gender=MASCULINE|case=ACCUSATIVE	
,	comma	CONJ	_	
tertius	tertius	ADJ	number=SINGULAR|gender=MASCULINE|case=NOMINATIVE	
e	ex	PREP	_	
caelo	caelum	NN	number=SINGULAR|gender=NEUTER|case=ABLATIVE	
cecidit	cado	VB	person=PERSON_3|number=SINGULAR|tense=PERF|mood=INDICATIVE|voice=ACTIVE	
Cato	Cato	NN	number=SINGULAR|gender=MASCULINE|case=NOMINATIVE	
ego	ego	PRON	number=SINGULAR|gender=MASCULINE|case=NOMINATIVE	
te	tu	PRON	number=SINGULAR|gender=MASCULINE|case=ACCUSATIVE	
ceventem	ceveo	VB	number=SINGULAR|tense=PR|mood=PARTICIPLE|gender=MASCULINE|case=ACCUSATIVE	
Sexte	Sextus	NN	number=SINGULAR|gender=MASCULINE|case=VOCATIVE	
verebor	vereor	VB	person=PERSON_1|number=SINGULAR|tense=FUTURE|mood=INDICATIVE|voice=PASSIVE	
luctantur	luctor	VB	person=PERSON_3|number=PLURAL|tense=PR|mood=INDICATIVE|voice=PASSIVE	
paucae	paucus	ADJ	number=PLURAL|gender=FEMININE|case=NOMINATIVE	
,	comma	CONJ	_	
comedunt	comedo	VB	person=PERSON_3|number=PLURAL|tense=PR|voice=ACTIVE	
colyphia	colyphia	NN	number=PLURAL|gender=NEUTER|case=ACCUSATIVE	
paucae	paucus	ADJ	number=PLURAL|gender=FEMININE|case=NOMINATIVE	
nubit	nubo	VB	person=PERSON_3|number=SINGULAR|tense=PR|mood=INDICATIVE|voice=ACTIVE	
amicus	amicus	ADJ	number=SINGULAR|gender=MASCULINE|case=NOMINATIVE	
ne	ne	ADV	_	
-c	que	CONJ	_	
multos	multus	ADJ	number=PLURAL|gender=MASCULINE|case=ACCUSATIVE	
adhibet	adhibeo	VB	person=PERSON_3|number=SINGULAR|tense=PR|mood=INDICATIVE|voice=ACTIVE	
.	unknown		_	
"	unknown		_	
talia	talis	ADJ	number=PLURAL|gender=NEUTER|case=ACCUSATIVE	
secreta	secerno	VB	number=SINGULAR|tense=PERF|mood=PARTICIPLE|voice=PASSIVE|gender=FEMININE|case=ABLATIVE	
coluerunt	colo	VB	person=PERSON_3|number=PLURAL|tense=PERF|mood=INDICATIVE|voice=ACTIVE	
orgia	Orgia	NN	number=PLURAL|gender=NEUTER|case=ACCUSATIVE	
taeda	taeda	NN	number=SINGULAR|gender=FEMININE|case=ABLATIVE	
Cecropiam	Cecropius	ADJ	number=SINGULAR|gender=FEMININE|case=ACCUSATIVE	
soliti	soleo	VB	number=PLURAL|tense=PERF|mood=PARTICIPLE|voice=PASSIVE|gender=MASCULINE|case=NOMINATIVE	
Baptae	Baptae	NN	number=PLURAL|gender=MASCULINE|case=NOMINATIVE	
lassare	lasso	VB	tense=PR|mood=INFINITIVE|voice=ACTIVE	
Cotyton	Cotytto	NN	number=SINGULAR|gender=FEMININE|case=ACCUSATIVE	
ultra	ultra	ADV	_	
Sauromatas	Sauromates	NN	number=PLURAL|gender=MASCULINE|case=ACCUSATIVE	
fugere	fugio	VB	tense=PR|mood=INFINITIVE|voice=ACTIVE	
hinc	hinc	ADV	_	
libet	libet	VB	person=PERSON_3|number=SINGULAR|tense=PR|mood=INDICATIVE|voice=ACTIVE	
et	et	CONJ	_	
glacialem	glacialis	ADJ	number=SINGULAR|gender=MASCULINE|case=ACCUSATIVE	
Oceanum	Oceanus	NN	number=SINGULAR|gender=MASCULINE|case=ACCUSATIVE	
quotiens	quotiens	ADV	_	
aliquid	aliquis	PRON	number=SINGULAR|gender=NEUTER|case=ACCUSATIVE	
de	de	PREP	_	
moribus	mos	NN	number=PLURAL|gender=MASCULINE|case=ABLATIVE	
audent	audeo	VB	person=PERSON_3|number=PLURAL|tense=PR|mood=INDICATIVE|voice=ACTIVE	
qui	qui	NN	number=PLURAL|gender=MASCULINE|case=NOMINATIVE	
Curios	Curius	ADJ	number=PLURAL|gender=MASCULINE|case=ACCUSATIVE|degree=POSITIVE	
simulant	simulo	VB	person=PERSON_3|number=PLURAL|tense=PR|mood=INDICATIVE|voice=ACTIVE	
et	et	CONJ	_	
Bacchanalia	Bacchanalis	ADJ	number=PLURAL|gender=NEUTER|case=ACCUSATIVE|degree=POSITIVE	
vivunt	vivo	VB	person=PERSON_3|number=PLURAL|tense=PR|mood=INDICATIVE|voice=ACTIVE	
.	unknown		_	
frontis	frons	NN	number=SINGULAR|gender=FEMININE|case=GENITIVE	
nulla	nullus	ADJ	number=SINGULAR|gender=FEMININE|case=NOMINATIVE	
fides	fides	NN	number=SINGULAR|gender=FEMININE|case=NOMINATIVE	
infamis	infamis	ADJ	number=SINGULAR|gender=MASCULINE|case=NOMINATIVE	
Varillus	Varillus	NN	number=SINGULAR|gender=MASCULINE|case=NOMINATIVE	
ait	aio	VB	person=PERSON_3|number=SINGULAR|tense=PR|mood=INDICATIVE|voice=ACTIVE	
quo	qui	PRON	number=SINGULAR|gender=NEUTER|case=ABLATIVE	
deterior	deterior	ADJ	number=SINGULAR|gender=MASCULINE|case=NOMINATIVE|degree=COMPARATIVE	
te	tu	PRON	number=SINGULAR|gender=MASCULINE|case=ABLATIVE	
tu	tu	PRON	number=SINGULAR|gender=FEMININE|case=VOCATIVE	
nube	nubo	VB	person=PERSON_2|number=SINGULAR|tense=PR|mood=IMPERATIVE|voice=ACTIVE	
atque	atque	CONJ	_	
tace	taceo	VB	person=PERSON_2|number=SINGULAR|tense=PR|mood=IMPERATIVE|voice=ACTIVE	
liceat	liceo	VB	person=PERSON_3|number=SINGULAR|tense=PR|mood=SUBJUNCTIVE|voice=ACTIVE	
modo	modo	ADV	_	
vivere	vivo	VB	tense=PR|mood=INFINITIVE|voice=ACTIVE	
fient	fio	VB	person=PERSON_3|number=PLURAL|tense=FUTURE|mood=INDICATIVE|voice=ACTIVE	
,	comma	CONJ	_	
fient	fio	VB	person=PERSON_3|number=PLURAL|tense=FUTURE|mood=INDICATIVE|voice=ACTIVE	
ista	iste	PRON	number=PLURAL|gender=NEUTER|case=NOMINATIVE	
palam	palam	ADV	_	
cupient	cupio	VB	person=PERSON_3|number=PLURAL|tense=FUTURE|mood=INDICATIVE|voice=ACTIVE	
et	et	CONJ	_	
in	in	PREP	_	
acta	actum	NN	number=PLURAL|gender=NEUTER|case=ACCUSATIVE	
referri	refero	VB	tense=PR|mood=INFINITIVE|voice=PASSIVE	
.	unknown		_	
nemo	nemo	NN	number=SINGULAR|gender=MASCULINE|case=NOMINATIVE	
repente	repens	ADV	_	
fuit	sum	VB	person=PERSON_3|number=SINGULAR|tense=PERF|mood=INDICATIVE|voice=ACTIVE	
turpissimus	turpis	ADJ	number=SINGULAR|gender=MASCULINE|case=NOMINATIVE|degree=SUPERLATIVE	
.	unknown		_	
ille	ille	PRON	number=SINGULAR|gender=MASCULINE|case=NOMINATIVE	
supercilium	supercilium	NN	number=SINGULAR|gender=NEUTER|case=ACCUSATIVE	
madida	madidus	ADJ	number=SINGULAR|gender=FEMININE|case=ABLATIVE	
fuligine	fuligo	NN	number=SINGULAR|gender=FEMININE|case=ABLATIVE	
tinctum	tingo	VB	number=SINGULAR|tense=PERF|mood=PARTICIPLE|voice=PASSIVE|gender=NEUTER|case=ACCUSATIVE	
obliqua	obliquus	ADJ	number=SINGULAR|gender=FEMININE|case=ABLATIVE	
producit	produco	VB	person=PERSON_3|number=SINGULAR|tense=PR|mood=INDICATIVE|voice=ACTIVE	
acu	acus	NN	number=SINGULAR|gender=FEMININE|case=ABLATIVE	
pingit	pingo	VB	person=PERSON_3|number=SINGULAR|tense=PR|mood=INDICATIVE|voice=ACTIVE	
que	que	CONJ	_	
trementis	tremo	VB	number=PLURAL|tense=PR|mood=PARTICIPLE|gender=MASCULINE|case=ACCUSATIVE	
attolens	attollo	VB	number=SINGULAR|tense=PR|mood=PARTICIPLE|voice=ACTIVE|gender=MASCULINE|case=NOMINATIVE|degree=POSITIVE	
oculos	oculus	NN	number=PLURAL|gender=MASCULINE|case=ACCUSATIVE	
cuperent	cupio	VB	person=PERSON_3|number=PLURAL|tense=IMP|mood=SUBJUNCTIVE|voice=ACTIVE	
lustrari	lustro	VB	tense=PR|mood=INFINITIVE|voice=PASSIVE	
si	si	CONJ	_	
qua	quis	PRON	number=PLURAL|gender=NEUTER|case=NOMINATIVE	
darentur	do	VB	person=PERSON_3|number=PLURAL|tense=IMP|mood=SUBJUNCTIVE|voice=PASSIVE	
sulpura	sulphur	NN	number=PLURAL|gender=NEUTER|case=NOMINATIVE	
cum	cum	PREP	_	
taedis	taeda	NN	number=PLURAL|gender=FEMININE|case=ABLATIVE	
et	et	CONJ	_	
si	si	CONJ	_	
foret	sum	VB	person=PERSON_3|number=SINGULAR|tense=IMP|mood=SUBJUNCTIVE|voice=ACTIVE	
umida	umidus	ADJ	number=SINGULAR|gender=FEMININE|case=NOMINATIVE	
laurus	laurus	NN	number=SINGULAR|gender=FEMININE|case=NOMINATIVE	
.	unknown		_	
