aude	audeo	VB	person=PERSON_2|number=SINGULAR|tense=PR|mood=IMPERATIVE|voice=ACTIVE	
aliquid	aliquis	PRON	number=SINGULAR|gender=NEUTER|case=ACCUSATIVE	
brevibus	brevis	ADJ	number=PLURAL|gender=NEUTER|case=ABLATIVE	
Gyaris	Gyara	NN	number=PLURAL|gender=NEUTER|case=ABLATIVE	
et	et	CONJ	_	
carcere	carcer	NN	number=SINGULAR|gender=MASCULINE|case=ABLATIVE	
dignum	dignus	ADJ	number=SINGULAR|gender=NEUTER|case=ACCUSATIVE	
si	si	CONJ	_	
vis	volo	VB	person=PERSON_2|number=SINGULAR|tense=PR|mood=INDICATIVE|voice=ACTIVE	
esse	sum	VB	tense=PR|mood=INFINITIVE|voice=ACTIVE	
aliquid	aliquis	PRON	number=SINGULAR|gender=NEUTER|case=NOMINATIVE	
densissima	densus	ADJ	number=SINGULAR|gender=FEMININE|case=NOMINATIVE|degree=SUPERLATIVE	
centum	centum	NRL	_	
quadrantes	quadrans	NN	number=PLURAL|gender=MASCULINE|case=ACCUSATIVE	
lectica	lectica	NN	number=SINGULAR|gender=FEMININE|case=NOMINATIVE	
petit	peto	VB	person=PERSON_3|number=SINGULAR|tense=PR|mood=INDICATIVE|voice=ACTIVE	
,			_	
sequitur	sequor	VB	person=PERSON_3|number=SINGULAR|tense=PR|mood=INDICATIVE|voice=PASSIVE	
-que	que	CONJ	_	
maritum	maritus	NN	number=SINGULAR|gender=MASCULINE|case=ACCUSATIVE	
languida	languidus	ADJ	number=SINGULAR|gender=FEMININE|case=NOMINATIVE	
vel	vel	CONJ	_	
praegnas	praegnas	ADJ	number=SINGULAR|gender=FEMININE|case=NOMINATIVE|degree=POSITIVE	
et	et	CONJ	_	
circumducitur	circumduco	VB	person=PERSON_3|number=SINGULAR|tense=PR|mood=INDICATIVE|voice=PASSIVE	
uxor	uxor	NN	number=SINGULAR|gender=FEMININE|case=NOMINATIVE	
alea	alea	NN	number=SINGULAR|gender=FEMININE|case=NOMINATIVE	
quando	quando	ADV	_	
hos	hic	PRON	number=PLURAL|gender=MASCULINE|case=ACCUSATIVE	
animos	animus	NN	number=PLURAL|gender=MASCULINE|case=ACCUSATIVE	
Occurrit	occurro	VB	person=PERSON_3|number=SINGULAR|tense=PR|mood=INDICATIVE|voice=ACTIVE	
matrona	matrona	NN	number=SINGULAR|gender=FEMININE|case=NOMINATIVE	
potens	potens	ADJ	number=SINGULAR|gender=FEMININE|case=NOMINATIVE	
quae	qui	PRON	number=SINGULAR|gender=FEMININE|case=NOMINATIVE	
molle	mollis	ADJ	number=SINGULAR|gender=NEUTER|case=ACCUSATIVE	
Calenum	Calenum	NN	number=SINGULAR|gender=NEUTER|case=ACCUSATIVE	
porrectura	porrigo	VB	number=SINGULAR|tense=FUTURE|mood=PARTICIPLE|voice=ACTIVE|gender=FEMININE|case=NOMINATIVE	
viro	vir	NN	number=SINGULAR|gender=MASCULINE|case=ABLATIVE	
miscet	misceo	VB	person=PERSON_3|number=SINGULAR|tense=PR|mood=INDICATIVE|voice=ACTIVE	
sitiente	sitio	VB	number=SINGULAR|tense=PR|mood=PARTICIPLE|gender=MASCULINE|case=ABLATIVE	
rubetam	rubeta	NN	number=SINGULAR|gender=FEMININE|case=ACCUSATIVE	
instituit	instituo	VB	person=PERSON_3|number=SINGULAR|tense=PR|mood=INDICATIVE|voice=ACTIVE	
que	que	CONJ	_	
rudes	rudis	ADJ	number=PLURAL|gender=FEMININE|case=ACCUSATIVE	
melior	bonus	ADJ	number=SINGULAR|gender=FEMININE|case=NOMINATIVE|degree=COMPARATIVE	
Lucusta	Locusta	NN	number=SINGULAR|gender=FEMININE|case=NOMINATIVE	
propinquas	propinquus	ADJ	number=PLURAL|gender=FEMININE|case=ACCUSATIVE	
per	per	PREP	_	
famam	fama	NN	number=SINGULAR|gender=FEMININE|case=ACCUSATIVE	
et	et	CONJ	_	
populum	populus	NN	number=SINGULAR|gender=MASCULINE|case=ACCUSATIVE	
nigros	niger	ADJ	number=PLURAL|gender=MASCULINE|case=ACCUSATIVE	
efferre	effero	VB	tense=PR|mood=INFINITIVE|voice=ACTIVE	
maritos	maritus	ADJ	number=PLURAL|gender=MASCULINE|case=ACCUSATIVE	
agnitus	agnosco	VB	number=SINGULAR|tense=PERF|mood=PARTICIPLE|voice=PASSIVE|gender=MASCULINE|case=NOMINATIVE|degree=POSITIVE	
accipies	accipio	VB	person=PERSON_2|number=SINGULAR|tense=FUTURE|mood=INDICATIVE|voice=ACTIVE	
accusator	accusator	NN	number=SINGULAR|gender=MASCULINE|case=NOMINATIVE	
erit	sum	VB	person=PERSON_3|number=SINGULAR|tense=FUTURE|mood=INDICATIVE|voice=ACTIVE	
qui	qui	NN	number=SINGULAR|gender=MASCULINE|case=NOMINATIVE	
verbum	verbum	NN	number=SINGULAR|gender=NEUTER|case=ACCUSATIVE	
dixerit	dico	VB	person=PERSON_3|number=SINGULAR|tense=FUTUREPERFECT|mood=INDICATIVE|voice=ACTIVE	
'			_	
hic	hic	PRON	number=SINGULAR|gender=MASCULINE|case=NOMINATIVE	
est	sum	VB	person=PERSON_3|number=SINGULAR|tense=PR|mood=INDICATIVE|voice=ACTIVE	
.'			_	
taeda	taeda	NN	number=SINGULAR|gender=FEMININE|case=ABLATIVE	
lucebis	luceo	VB	person=PERSON_2|number=SINGULAR|tense=FUTURE|mood=INDICATIVE|voice=ACTIVE	
in	in	PREP	_	
illa	ille	PRON	number=SINGULAR|gender=FEMININE|case=ABLATIVE	
qua	qui	NN	number=SINGULAR|gender=FEMININE|case=ABLATIVE	
stantes	sto	VB	number=PLURAL|tense=PR|mood=PARTICIPLE|gender=MASCULINE|case=NOMINATIVE	
ardent	ardeo	VB	person=PERSON_3|number=PLURAL|tense=PR|mood=INDICATIVE|voice=ACTIVE	
qui	quis	PRON	number=PLURAL|gender=MASCULINE|case=NOMINATIVE	
fixo	figo	VB	number=SINGULAR|tense=PERF|mood=PARTICIPLE|voice=PASSIVE|gender=NEUTER|case=ABLATIVE	
gutture	guttur	NN	number=SINGULAR|gender=NEUTER|case=ABLATIVE	
fumant	fumo	VB	person=PERSON_3|number=PLURAL|tense=PR|mood=INDICATIVE|voice=ACTIVE	
et	et	CONJ	_	
latum	latus	ADJ	number=SINGULAR|gender=MASCULINE|case=ACCUSATIVE	
media	medius	ADJ	number=SINGULAR|gender=FEMININE|case=ABLATIVE	
sulcum	sulcus	ADJ	number=SINGULAR|gender=MASCULINE|case=ACCUSATIVE	
deducis	deduco	VB	person=PERSON_2|number=SINGULAR|tense=PR|mood=INDICATIVE|voice=ACTIVE	
harena	harena	NN	number=SINGULAR|gender=FEMININE|case=ABLATIVE	
.			_	
nunc	nunc	ADV	_	
sportula	sportula	NN	number=SINGULAR|gender=FEMININE|case=NOMINATIVE	
primo	primus	ADJ	number=SINGULAR|gender=NEUTER|case=ABLATIVE	
limine	limen	NN	number=SINGULAR|gender=NEUTER|case=ABLATIVE	
parva	parvus	ADJ	number=SINGULAR|gender=FEMININE|case=NOMINATIVE	
sedet	sedeo	VB	person=PERSON_3|number=SINGULAR|tense=PR|mood=INDICATIVE|voice=ACTIVE	
turbae	turba	NN	number=SINGULAR|gender=FEMININE|case=DATIVE	
rapienda	rapio	VB	number=SINGULAR|mood=GERUNDIVE|gender=FEMININE|case=NOMINATIVE	
togatae	togatus	ADJ	number=SINGULAR|gender=FEMININE|case=DATIVE	
"			_	
cum	cum	CONJ	_	
veniet	venio	VB	person=PERSON_3|number=SINGULAR|tense=FUTURE|mood=INDICATIVE|voice=ACTIVE	
contra	contra	ADV	_	
digito	digitus	NN	number=SINGULAR|gender=MASCULINE|case=ABLATIVE	
compesce	compesco	VB	person=PERSON_2|number=SINGULAR|tense=PR|mood=IMPERATIVE|voice=ACTIVE	
labellum	labellum	NN	number=SINGULAR|gender=NEUTER|case=ACCUSATIVE	
dicas	dico	VB	person=PERSON_2|number=SINGULAR|tense=PR|mood=SUBJUNCTIVE|voice=ACTIVE	
hic	hic	ADV	_	
forsitan	forsitan	ADV	_	
unde	unde	ADV	_	
ingenium	ingenium	NN	number=SINGULAR|gender=NEUTER|case=NOMINATIVE	
par	par	ADJ	number=SINGULAR|gender=NEUTER|case=NOMINATIVE	
materiae	materia	NN	number=SINGULAR|gender=FEMININE|case=DATIVE	
prior	prior	ADJ	number=SINGULAR|gender=MASCULINE|case=NOMINATIVE|degree=COMPARATIVE	
inquit	inquam	VB	person=PERSON_3|number=SINGULAR|tense=PR|mood=INDICATIVE|voice=ACTIVE	
ego	ego	PRON	number=SINGULAR|gender=MASCULINE|case=NOMINATIVE	
adsum	adsum	VB	person=PERSON_1|number=SINGULAR|tense=PR|mood=INDICATIVE|voice=ACTIVE	
nam	nam	CONJ	_	
quis	quis	PRON	number=SINGULAR|gender=MASCULINE|case=NOMINATIVE	
iniquae	iniquus	ADJ	number=SINGULAR|gender=FEMININE|case=GENITIVE	
tam	tam	ADV	_	
patiens	patior	VB	number=SINGULAR|tense=PR|mood=PARTICIPLE|gender=MASCULINE|case=NOMINATIVE	
urbis	urbs	NN	number=SINGULAR|gender=FEMININE|case=GENITIVE	
,	comma	CONJ	_	
tam	tam	ADV	_	
ferreus	ferreus	ADJ	number=SINGULAR|gender=MASCULINE|case=NOMINATIVE	
ut	ut	ADV	_	
teneat	teneo	VB	person=PERSON_3|number=SINGULAR|tense=PR|mood=SUBJUNCTIVE|voice=ACTIVE	
se	sui	PRON	number=PLURAL|gender=MASCULINE|case=ACCUSATIVE	
causidici	causidicus	NN	number=SINGULAR|gender=MASCULINE|case=GENITIVE	
nova	novus	ADJ	number=SINGULAR|gender=FEMININE|case=NOMINATIVE	
cum	cum	CONJ	_	
veniat	venio	VB	person=PERSON_3|number=SINGULAR|tense=PR|mood=SUBJUNCTIVE|voice=ACTIVE	
lectica	lectica	NN	number=SINGULAR|gender=FEMININE|case=NOMINATIVE	
Mathonis	Matho	NN	number=SINGULAR|gender=MASCULINE|case=GENITIVE	
plena	plenus	ADJ	number=SINGULAR|gender=FEMININE|case=NOMINATIVE	
ipso	ipse	PRON	number=SINGULAR|gender=MASCULINE|case=ABLATIVE	
post	post	PREP	_	
hunc	hic	PRON	number=SINGULAR|gender=MASCULINE|case=ACCUSATIVE	
magni	magnus	ADJ	number=SINGULAR|gender=MASCULINE|case=GENITIVE	
delator	delator	NN	number=SINGULAR|gender=MASCULINE|case=NOMINATIVE	
amici	amicus	NN	number=SINGULAR|gender=MASCULINE|case=GENITIVE	
et	et	CONJ	_	
cito	cito	ADV	_	
rapturus	rapio	VB	number=SINGULAR|tense=FUTURE|mood=PARTICIPLE|voice=ACTIVE|gender=MASCULINE|case=NOMINATIVE	
de	de	PREP	_	
nobilitate	nobilitas	NN	number=SINGULAR|gender=FEMININE|case=ABLATIVE	
comesa	comedo	VB	number=SINGULAR|tense=PERF|mood=PARTICIPLE|voice=PASSIVE|gender=FEMININE|case=ABLATIVE|degree=POSITIVE	
quod	qui	NN	number=SINGULAR|gender=NEUTER|case=NOMINATIVE	
superest	supersum	VB	person=PERSON_3|number=SINGULAR|tense=PR|mood=INDICATIVE|voice=ACTIVE	
quem	qui	PRON	number=SINGULAR|gender=MASCULINE|case=ACCUSATIVE	
Massa	Massa	NN	number=SINGULAR|gender=MASCULINE|case=NOMINATIVE	
timet	timeo	VB	person=PERSON_3|number=SINGULAR|tense=PR|mood=INDICATIVE|voice=ACTIVE	
quem	qui	NN	number=SINGULAR|gender=MASCULINE|case=ACCUSATIVE	
munere	munus	NN	number=SINGULAR|gender=NEUTER|case=ABLATIVE	
palpat	palpo	VB	person=PERSON_3|number=SINGULAR|tense=PR|mood=INDICATIVE|voice=ACTIVE	
Carus	carus	ADJ	number=SINGULAR|gender=MASCULINE|case=NOMINATIVE	
et	et	CONJ	_	
a	ab	PREP	_	
trepido	trepidus	ADJ	number=SINGULAR|gender=MASCULINE|case=ABLATIVE	
Thymele	Thymele	NN	number=SINGULAR|gender=FEMININE|case=NOMINATIVE	
summissa	summitto	VB	number=SINGULAR|tense=PERF|mood=PARTICIPLE|voice=PASSIVE|gender=FEMININE|case=NOMINATIVE	
Latino	Latinus	ADJ	number=SINGULAR|gender=MASCULINE|case=ABLATIVE	
cum	cum	CONJ	_	
te	tu	PRON	number=SINGULAR|gender=MASCULINE|case=ACCUSATIVE	
summoveant	summoveo	VB	person=PERSON_3|number=PLURAL|tense=PR|mood=SUBJUNCTIVE|voice=ACTIVE	
qui	qui	PRON	number=PLURAL|gender=MASCULINE|case=NOMINATIVE	
testamenta	testamentum	NN	number=PLURAL|gender=NEUTER|case=ACCUSATIVE	
merentur	mereor	VB	person=PERSON_3|number=PLURAL|tense=PR|mood=INDICATIVE|voice=PASSIVE	
noctibus	nox	NN	number=PLURAL|gender=FEMININE|case=ABLATIVE	
in	in	PREP	_	
caelum	caelum	NN	number=SINGULAR|gender=NEUTER|case=ACCUSATIVE	
quos	qui	PRON	number=PLURAL|gender=MASCULINE|case=ACCUSATIVE	
evehit	eveho	VB	person=PERSON_3|number=SINGULAR|tense=PR|mood=INDICATIVE|voice=ACTIVE	
optima	bonus	ADJ	number=SINGULAR|gender=FEMININE|case=NOMINATIVE	
summi	summus	ADJ	number=SINGULAR|gender=MASCULINE|case=GENITIVE	
nunc	nunc	ADV	_	
via	via	NN	number=SINGULAR|gender=FEMININE|case=NOMINATIVE	
processus	processus	NN	number=SINGULAR|gender=MASCULINE|case=GENITIVE	
vetulae	vetulus	ADJ	number=SINGULAR|gender=FEMININE|case=GENITIVE	
vesica	vesica	NN	number=SINGULAR|gender=FEMININE|case=NOMINATIVE	
beatae	beatus	ADJ	number=SINGULAR|gender=FEMININE|case=GENITIVE	
sed	sed	CONJ	_	
quis	quis	PRON	number=SINGULAR|gender=MASCULINE|case=NOMINATIVE	
ferat	fero	VB	person=PERSON_3|number=SINGULAR|tense=PR|mood=SUBJUNCTIVE|voice=ACTIVE	
istas	iste	PRON	number=PLURAL|gender=FEMININE|case=ACCUSATIVE	
luxuriae	luxuria	NN	number=SINGULAR|gender=FEMININE|case=GENITIVE	
sordes	sordes	NN	number=PLURAL|gender=FEMININE|case=ACCUSATIVE	
?			_	
experiar	experior	VB	person=PERSON_1|number=SINGULAR|tense=FUTURE|mood=INDICATIVE|voice=PASSIVE	
quid	quis	PRON	number=SINGULAR|gender=NEUTER|case=NOMINATIVE	
concedatur	concedo	VB	person=PERSON_3|number=SINGULAR|tense=PR|mood=SUBJUNCTIVE|voice=PASSIVE	
in	in	PREP	_	
illos	ille	PRON	number=PLURAL|gender=MASCULINE|case=ACCUSATIVE	
quorum	qui	PRON	number=PLURAL|gender=MASCULINE|case=GENITIVE	
Flaminia	flaminius	ADJ	number=SINGULAR|gender=FEMININE|case=ABLATIVE	
tegitur	tego	VB	person=PERSON_3|number=SINGULAR|tense=PR|mood=INDICATIVE|voice=PASSIVE	
cinis	cinis	NN	number=SINGULAR|gender=MASCULINE|case=NOMINATIVE	
atque	atque	CONJ	_	
Latina	Latinus	ADJ	number=SINGULAR|gender=FEMININE|case=ABLATIVE|degree=POSITIVE	
.			_	
hic	hic	PRON	number=SINGULAR|gender=MASCULINE|case=NOMINATIVE	
petit	peto	VB	person=PERSON_3|number=SINGULAR|tense=PR|mood=INDICATIVE|voice=ACTIVE	
absenti	absum	VB	number=SINGULAR|tense=PR|mood=PARTICIPLE|gender=FEMININE|case=DATIVE	
nota	nosco	VB	number=SINGULAR|tense=PERF|mood=PARTICIPLE|voice=PASSIVE|gender=FEMININE|case=ABLATIVE	
iam	jam	ADV	_	
callidus	callidus	ADJ	number=SINGULAR|gender=MASCULINE|case=NOMINATIVE	
arte	ars	NN	number=SINGULAR|gender=FEMININE|case=ABLATIVE	
ostendens	ostendo	VB	number=SINGULAR|tense=PR|mood=PARTICIPLE|gender=MASCULINE|case=NOMINATIVE	
vacuam	vacuus	ADJ	number=SINGULAR|gender=FEMININE|case=ACCUSATIVE	
et	et	CONJ	_	
clausam	claudo	VB	number=SINGULAR|tense=PERF|mood=PARTICIPLE|voice=PASSIVE|gender=FEMININE|case=ACCUSATIVE	
pro	pro	PREP	_	
coniuge	conjunx	NN	number=SINGULAR|gender=FEMININE|case=ABLATIVE	
sellam	sella	NN	number=SINGULAR|gender=FEMININE|case=ACCUSATIVE	
.			_	
nam	nam	ADV	_	
de	de	PREP	_	
tot	tot	IRREG	_	
pulchris	pulcher	ADJ	number=PLURAL|gender=MASCULINE|case=ABLATIVE	
et	et	CONJ	_	
latis	latus	ADJ	number=PLURAL|gender=MASCULINE|case=ABLATIVE	
orbibus	orbis	NN	number=PLURAL|gender=MASCULINE|case=ABLATIVE	
et	et	CONJ	_	
tam	tam	ADV	_	
antiquis	antiquus	ADJ	number=PLURAL|gender=MASCULINE|case=ABLATIVE	
una	unus	ADJ	number=SINGULAR|gender=FEMININE|case=ABLATIVE	
comedunt	comedo	VB	person=PERSON_3|number=PLURAL|tense=PR|voice=ACTIVE	
patrimonia	patrimonium	NN	number=PLURAL|gender=NEUTER|case=ACCUSATIVE	
mensa	mensa	NN	number=SINGULAR|gender=FEMININE|case=ABLATIVE	
cur	cur	ADV	_	
tamen	tamen	ADV	_	
hoc	hic	PRON	number=SINGULAR|gender=MASCULINE|case=ABLATIVE	
potius	potis	ADV	degree=COMPARATIVE	
libeat	libet	VB	person=PERSON_3|number=SINGULAR|tense=PR|mood=SUBJUNCTIVE|voice=ACTIVE	
decurrere	decurro	VB	tense=PR|mood=INFINITIVE|voice=ACTIVE	
campo	campus	NN	number=SINGULAR|gender=MASCULINE|case=ABLATIVE	
per	per	PREP	_	
quem	qui	PRON	number=SINGULAR|gender=MASCULINE|case=ACCUSATIVE	
magnus	magnus	ADJ	gender=MASCULINE|case=NOMINATIVE	
equos	equus	NN	number=PLURAL|gender=MASCULINE|case=ACCUSATIVE	
Auruncae	Aurunca	NN	gender=FEMININE|case=GENITIVE	
flexit	flecto	VB	person=PERSON_3|number=SINGULAR|tense=PERF|mood=INDICATIVE|voice=ACTIVE	
alumnus	alumnus	ADJ	number=SINGULAR|gender=MASCULINE|case=NOMINATIVE	
,	unknown		_	
si	si	CONJ	_	
vacat	vaco	VB	person=PERSON_3|number=SINGULAR|tense=PR|mood=INDICATIVE|voice=ACTIVE	
ac	atque	CONJ	_	
placidi	placidus	ADJ	number=PLURAL|gender=MASCULINE|case=NOMINATIVE	
rationem	ratio	NN	number=SINGULAR|gender=FEMININE|case=ACCUSATIVE	
admittitis	admitto	VB	person=PERSON_2|number=PLURAL|tense=PR|mood=INDICATIVE|voice=ACTIVE	
,	unknown		_	
edam	edo	VB	person=PERSON_1|number=SINGULAR|tense=FUTURE|mood=INDICATIVE|voice=ACTIVE	
accipiat	accipio	VB	person=PERSON_3|number=SINGULAR|tense=PR|mood=SUBJUNCTIVE|voice=ACTIVE	
sane	sanus	ADV	_	
mercedem	merces	NN	number=SINGULAR|gender=FEMININE|case=ACCUSATIVE	
sanguinis	sanguis	NN	number=SINGULAR|gender=MASCULINE|case=GENITIVE	
et	et	CONJ	_	
sic	sic	ADV	_	
palleat	palleo	VB	person=PERSON_3|number=SINGULAR|tense=PR|mood=SUBJUNCTIVE|voice=ACTIVE	
ut	ut	CONJ	_	
nudis	nudus	ADJ	number=PLURAL|gender=FEMININE|case=ABLATIVE	
pressit	premo	VB	person=PERSON_3|number=SINGULAR|tense=PERF|mood=INDICATIVE|voice=ACTIVE	
qui	qui	PRON	number=SINGULAR|gender=MASCULINE|case=NOMINATIVE	
calcibus	calx	NN	number=PLURAL|gender=FEMININE|case=ABLATIVE	
anguem	anguis	ADJ	number=SINGULAR|gender=MASCULINE|case=ACCUSATIVE	
aut	aut	CONJ	_	
Lugudunensem	Lugudunensis	ADJ	number=SINGULAR|gender=FEMININE|case=ACCUSATIVE	
rhetor	rhetor	NN	number=SINGULAR|gender=MASCULINE|case=NOMINATIVE	
dicturus	dico	VB	number=SINGULAR|tense=FUTURE|mood=PARTICIPLE|voice=ACTIVE|gender=MASCULINE|case=NOMINATIVE	
ad	ad	PREP	_	
aram	ara	NN	number=SINGULAR|gender=FEMININE|case=ACCUSATIVE	
cur	cur	ADV	_	
timeam	timeo	VB	person=PERSON_1|number=SINGULAR|tense=PR|mood=SUBJUNCTIVE|voice=ACTIVE	
dubitem	dubito	VB	person=PERSON_1|number=SINGULAR|tense=PR|mood=SUBJUNCTIVE|voice=ACTIVE	
-ve	ve	CONJ	_	
locum	locus	NN	number=SINGULAR|gender=MASCULINE|case=ACCUSATIVE	
defendere	defendo	VB	tense=PR|mood=INFINITIVE|voice=ACTIVE	
quamvis	quamvis	ADV	_	
natus	nascor	VB	number=SINGULAR|tense=PERF|mood=PARTICIPLE|voice=DEPONENS|gender=MASCULINE|case=NOMINATIVE|degree=POSITIVE	
ad	ad	PREP	_	
Euphraten	Euphrates	NN	number=SINGULAR|gender=MASCULINE|case=ACCUSATIVE	
molles	mollis	ADJ	number=PLURAL|gender=FEMININE|case=NOMINATIVE	
quod	qui	PRON	number=SINGULAR|gender=NEUTER|case=ACCUSATIVE	
in	in	PREP	_	
aure	auris	NN	number=SINGULAR|gender=FEMININE|case=ABLATIVE	
fenestrae	fenestra	NN	number=PLURAL|gender=FEMININE|case=NOMINATIVE	
arguerint	arguo	VB	person=PERSON_3|number=PLURAL|tense=PERF|mood=SUBJUNCTIVE|voice=ACTIVE	
Nonne	nonne	ADV	_	
libet	libet	VB	person=PERSON_3|number=SINGULAR|tense=PR|mood=INDICATIVE|voice=ACTIVE	
medio	medius	ADJ	number=SINGULAR|gender=NEUTER|case=ABLATIVE	
ceras	cera	NN	number=PLURAL|gender=FEMININE|case=ACCUSATIVE	
inplere	impleo	VB	mood=INFINITIVE|voice=ACTIVE	
capaces	capax	ADJ	number=PLURAL|gender=FEMININE|case=ACCUSATIVE	
quadrivio	quadrivium	NN	number=SINGULAR|gender=NEUTER|case=ABLATIVE	
cum	Cum	CONJ	_	
iam	jam	ADV	_	
sexta	sextus	ADJ	number=SINGULAR|gender=FEMININE|case=ABLATIVE	
cervice	cervix	NN	number=SINGULAR|gender=FEMININE|case=ABLATIVE	
feratur	fero	VB	person=PERSON_3|number=SINGULAR|tense=PR|mood=SUBJUNCTIVE|voice=PASSIVE	
hinc	hinc	ADV	_	
atque	atque	CONJ	_	
inde	inde	ADV	_	
patens	pateo	VB	number=SINGULAR|tense=PR|mood=PARTICIPLE|gender=MASCULINE|case=NOMINATIVE	
ac	atque	CONJ	_	
nuda	nudus	ADJ	number=SINGULAR|gender=FEMININE|case=ABLATIVE	
paene	paene	ADV	_	
cathedra	cathedra	NN	number=SINGULAR|gender=FEMININE|case=ABLATIVE	
et	et	CONJ	_	
multum	multus	ADJ	number=SINGULAR|gender=NEUTER|case=ACCUSATIVE	
referens	refero	VB	number=SINGULAR|tense=PR|mood=PARTICIPLE|gender=MASCULINE|case=NOMINATIVE	
de	de	PREP	_	
Maecenate	Maecenas	NN	number=SINGULAR|case=ABLATIVE	
supino	supinus	ADJ	number=SINGULAR|gender=MASCULINE|case=ABLATIVE	
signator	signator	NN	number=SINGULAR|gender=MASCULINE|case=NOMINATIVE	
falsi	falsum	NN	number=SINGULAR|gender=NEUTER|case=GENITIVE	
qui	qui	PRON	number=SINGULAR|gender=MASCULINE|case=NOMINATIVE	
se	sui	PRON	number=SINGULAR|gender=MASCULINE|case=ACCUSATIVE	
lautum	lavo	VB	number=SINGULAR|tense=PERF|mood=PARTICIPLE|voice=PASSIVE|gender=MASCULINE|case=ACCUSATIVE	
atque	atque	CONJ	_	
beatum	beatus	ADJ	number=SINGULAR|gender=MASCULINE|case=ACCUSATIVE	
exiguis	exiguus	ADJ	number=PLURAL|gender=FEMININE|case=ABLATIVE	
tabulis	tabula	NN	number=PLURAL|gender=FEMININE|case=ABLATIVE	
et	et	CONJ	_	
gemma	gemma	NN	number=SINGULAR|gender=FEMININE|case=ABLATIVE	
fecerit	facio	VB	person=PERSON_3|number=SINGULAR|tense=PERF|mood=SUBJUNCTIVE|voice=ACTIVE	
uda	udus	ADJ	number=SINGULAR|gender=FEMININE|case=ABLATIVE	
nulli	nullus	ADJ	number=SINGULAR|gender=MASCULINE|case=DATIVE	
gravis	gravis	ADJ	number=SINGULAR|gender=MASCULINE|case=NOMINATIVE	
est	sum	VB	person=PERSON_3|number=SINGULAR|tense=PR|mood=INDICATIVE|voice=ACTIVE	
percussus	percutio	VB	number=SINGULAR|tense=PERF|mood=PARTICIPLE|voice=PASSIVE|gender=MASCULINE|case=NOMINATIVE	
Achilles	Achilles	NN	number=SINGULAR|gender=MASCULINE|case=NOMINATIVE	
aut	aut	CONJ	_	
multum	multus	ADJ	number=SINGULAR|gender=NEUTER|case=ACCUSATIVE	
quaesitus	quaero	VB	number=SINGULAR|tense=PERF|mood=PARTICIPLE|voice=PASSIVE|gender=MASCULINE|case=NOMINATIVE	
Hylas	Hylas	NN	number=SINGULAR|gender=MASCULINE|case=NOMINATIVE	
urnam	urna	NN	number=SINGULAR|gender=FEMININE|case=ACCUSATIVE	
que	que	CONJ	_	
secutus	sequor	VB	number=SINGULAR|tense=PERF|mood=PARTICIPLE|voice=PASSIVE|gender=MASCULINE|case=NOMINATIVE	
licet	licet	VB	person=PERSON_3|number=SINGULAR|tense=PR|mood=INDICATIVE|voice=ACTIVE	
ipse	ipse	PRON	number=SINGULAR|gender=MASCULINE|case=NOMINATIVE	
negem	nego	VB	person=PERSON_1|number=SINGULAR|tense=PR|mood=SUBJUNCTIVE|voice=ACTIVE	
sed	sed	CONJ	_	
quinque	quinque	NRL	_	
tabernae	taberna	NN	number=PLURAL|gender=FEMININE|case=NOMINATIVE	
quadringenta	quadringenti	ADJ	number=PLURAL|gender=NEUTER|case=ACCUSATIVE	
parant	paro	VB	person=PERSON_3|number=PLURAL|tense=PR|mood=INDICATIVE|voice=ACTIVE	
.	comma	CONJ	_	
Cum	Cum	CONJ	_	
tener	tener	ADJ	number=SINGULAR|gender=MASCULINE|case=NOMINATIVE	
uxorem	uxor	NN	number=SINGULAR|gender=FEMININE|case=ACCUSATIVE	
ducat	duco	VB	person=PERSON_3|number=SINGULAR|tense=PR|mood=SUBJUNCTIVE|voice=ACTIVE	
spado	spado	NN	number=SINGULAR|gender=MASCULINE|case=NOMINATIVE	
,	comma	CONJ	_	
Mevia	Mevia	NN	number=SINGULAR|gender=FEMININE|case=NOMINATIVE	
Tuscum	Tuscus	ADJ	number=SINGULAR|gender=MASCULINE|case=ACCUSATIVE	
figat	figo	VB	person=PERSON_3|number=SINGULAR|tense=PR|mood=SUBJUNCTIVE|voice=ACTIVE	
aprum	aper	NN	number=SINGULAR|gender=MASCULINE|case=ACCUSATIVE	
et	et	CONJ	_	
nuda	nudus	ADJ	number=SINGULAR|gender=FEMININE|case=ABLATIVE	
teneat	teneo	VB	person=PERSON_3|number=SINGULAR|tense=PR|mood=SUBJUNCTIVE|voice=ACTIVE	
venabula	venabulum	NN	number=PLURAL|gender=NEUTER|case=ACCUSATIVE	
mamma	mamma	NN	number=SINGULAR|gender=FEMININE|case=ABLATIVE	
,	comma	CONJ	_	
patricios	patricius	ADJ	number=PLURAL|gender=MASCULINE|case=ACCUSATIVE	
omnis	omnis	ADJ	number=PLURAL|gender=MASCULINE|case=ACCUSATIVE	
opibus	ops	NN	number=PLURAL|gender=FEMININE|case=ABLATIVE	
cum	Cum	CONJ	_	
provocet	provoco	VB	person=PERSON_3|number=SINGULAR|tense=PR|mood=SUBJUNCTIVE|voice=ACTIVE	
unus	unus	ADJ	number=SINGULAR|gender=MASCULINE|case=NOMINATIVE	
quo	qui	PRON	number=SINGULAR|gender=MASCULINE|case=ABLATIVE	
tondente	tondeo	VB	number=SINGULAR|tense=PR|mood=PARTICIPLE|gender=MASCULINE|case=ABLATIVE	
gravis	gravis	ADJ	number=SINGULAR|gender=FEMININE|case=NOMINATIVE	
iuveni	juvenis	ADJ	number=SINGULAR|gender=MASCULINE|case=DATIVE	
mihi	ego	PRON	number=SINGULAR|gender=MASCULINE|case=DATIVE	
barba	barba	NN	number=SINGULAR|gender=FEMININE|case=NOMINATIVE	
sonabat	sono	VB	person=PERSON_3|number=SINGULAR|tense=IMP|mood=INDICATIVE|voice=ACTIVE	
,	unknown		_	
cum	Cum	CONJ	_	
pars	pars	NN	number=SINGULAR|gender=FEMININE|case=NOMINATIVE	
Niliacae	Niliacus	ADJ	number=SINGULAR|gender=FEMININE|case=GENITIVE	
plebis	plebs	NN	number=SINGULAR|gender=FEMININE|case=GENITIVE	
,	unknown		_	
cum	Cum	CONJ	_	
verna	verna	NN	number=SINGULAR|gender=MASCULINE|case=NOMINATIVE	
Canopi	Canopus	NN	number=SINGULAR|gender=MASCULINE|case=GENITIVE	
Crispinus	Crispinus	ADJ	number=SINGULAR|gender=MASCULINE|case=NOMINATIVE	
Tyrias	Tyrius	ADJ	number=PLURAL|gender=FEMININE|case=ACCUSATIVE	
umero	umerus	NN	number=SINGULAR|gender=MASCULINE|case=ABLATIVE	
revocante	revoco	VB	number=SINGULAR|tense=PR|mood=PARTICIPLE|gender=MASCULINE|case=ABLATIVE	
lacernas	lacerna	NN	number=PLURAL|gender=FEMININE|case=ACCUSATIVE	
ventilet	ventilo	VB	person=PERSON_3|number=SINGULAR|tense=PR|mood=SUBJUNCTIVE|voice=ACTIVE	
aestivum	aestivus	ADJ	number=SINGULAR|gender=NEUTER|case=ACCUSATIVE	
digitis	digitus	NN	number=PLURAL|gender=MASCULINE|case=ABLATIVE	
sudantibus	sudo	VB	number=PLURAL|tense=PR|mood=PARTICIPLE|gender=MASCULINE|case=ABLATIVE	
aurum	aurum	NN	number=SINGULAR|gender=NEUTER|case=ACCUSATIVE	
,	unknown		_	
ne	ne	ADV	_	
c	que	CONJ	_	
sufferre	suffero	VB	tense=PR|mood=INFINITIVE|voice=ACTIVE	
queat	queo	VB	person=PERSON_3|number=SINGULAR|tense=PR|mood=SUBJUNCTIVE|voice=ACTIVE	
maioris	magnus	ADJ	number=SINGULAR|gender=FEMININE|case=GENITIVE|degree=COMPARATIVE	
pondera	pondus	NN	number=PLURAL|gender=NEUTER|case=ACCUSATIVE	
gemmae	gemma	NN	number=SINGULAR|gender=FEMININE|case=GENITIVE	
,	unknown		_	
difficile	difficilis	ADJ	number=SINGULAR|gender=NEUTER|case=NOMINATIVE	
est	sum	VB	person=PERSON_3|number=SINGULAR|tense=PR|mood=INDICATIVE|voice=ACTIVE	
saturam	satura	NN	number=SINGULAR|gender=FEMININE|case=ACCUSATIVE	
non	non	ADV	_	
scribere	scribo	VB	tense=PR|mood=INFINITIVE|voice=ACTIVE	
criminibus	crimen	NN	number=PLURAL|gender=NEUTER|case=DATIVE	
debent	debeo	VB	person=PERSON_3|number=PLURAL|tense=PR|mood=INDICATIVE|voice=ACTIVE	
hortos	hortus	NN	number=PLURAL|gender=MASCULINE|case=ACCUSATIVE	
praetoria	praetorium	NN	number=PLURAL|gender=NEUTER|case=ACCUSATIVE	
mensas	mensa	NN	number=PLURAL|gender=FEMININE|case=ACCUSATIVE	
,	comma	CONJ	_	
argentum	argentum	NN	number=SINGULAR|gender=NEUTER|case=ACCUSATIVE	
vetus	vetus	ADJ	number=SINGULAR|gender=NEUTER|case=ACCUSATIVE	
et	et	CONJ	_	
stantem	sto	VB	number=SINGULAR|tense=PR|mood=PARTICIPLE|gender=MASCULINE|case=ACCUSATIVE	
extra	extra	PREP	_	
pocula	poculum	NN	number=PLURAL|gender=NEUTER|case=ACCUSATIVE	
caprum	caper	NN	number=SINGULAR|gender=MASCULINE|case=ACCUSATIVE	
.	unknown		_	
optima	bonus	ADJ	number=PLURAL|gender=NEUTER|case=ACCUSATIVE	
silvarum	silva	NN	number=PLURAL|gender=FEMININE|case=GENITIVE	
interea	interea	ADV	_	
pelagi	pelagus	NN	number=SINGULAR|gender=NEUTER|case=GENITIVE	
-que	que	CONJ	_	
vorabit	voro	VB	person=PERSON_3|number=SINGULAR|tense=FUTURE|mood=INDICATIVE|voice=ACTIVE	
rex	rex	NN	number=SINGULAR|gender=MASCULINE|case=NOMINATIVE	
horum	hic	PRON	number=PLURAL|gender=MASCULINE|case=GENITIVE	
,			_	
vacuis	vacuus	ADJ	number=PLURAL|gender=MASCULINE|case=ABLATIVE	
-que	que	CONJ	_	
toris	torus	NN	number=PLURAL|gender=MASCULINE|case=ABLATIVE	
tantum	tantus	ADJ	number=SINGULAR|gender=NEUTER|case=ACCUSATIVE	
ipse	ipse	PRON	number=SINGULAR|gender=MASCULINE|case=NOMINATIVE	
iacebit	jaceo	VB	person=PERSON_3|number=SINGULAR|tense=FUTURE|mood=INDICATIVE|voice=ACTIVE	
it	eo	VB	person=PERSON_3|number=SINGULAR|tense=PR|mood=INDICATIVE|voice=ACTIVE	
nova	novus	ADJ	number=SINGULAR|gender=FEMININE|case=NOMINATIVE	
ne	ne	ADV	_	
-c	c	CONJ	_	
tristis	tristis	ADJ	number=SINGULAR|gender=FEMININE|case=NOMINATIVE	
per	per	PREP	_	
cunctas	cunctus	ADJ	number=PLURAL|gender=FEMININE|case=ACCUSATIVE	
fabula	fabula	NN	number=SINGULAR|gender=FEMININE|case=NOMINATIVE	
cenas	cena	NN	number=PLURAL|gender=FEMININE|case=ACCUSATIVE	
:			_	
unciolam	unciola	NN	gender=FEMININE|case=ACCUSATIVE	
Proculeius	Proculeius	NN	number=SINGULAR|gender=MASCULINE|case=NOMINATIVE	
habet	habeo	VB	person=PERSON_3|number=SINGULAR|tense=PR|mood=INDICATIVE|voice=ACTIVE	
sed	sed	CONJ	_	
Gillo	Gillo	NN	number=SINGULAR|gender=MASCULINE|case=NOMINATIVE	
deuncem	deunx	NN	gender=MASCULINE|case=ACCUSATIVE	
partes	pars	NN	number=PLURAL|gender=FEMININE|case=ACCUSATIVE	
quisque	quisque	PRON	number=SINGULAR|gender=MASCULINE|case=NOMINATIVE	
suas	suus	ADJ	number=PLURAL|gender=FEMININE|case=ACCUSATIVE	
ad	ad	PREP	_	
mensuram	mensura	NN	number=SINGULAR|gender=FEMININE|case=ACCUSATIVE	
inguinis	inguen	NN	gender=NEUTER|case=GENITIVE	
heres	heres	NN	number=SINGULAR|gender=MASCULINE|case=NOMINATIVE	
poena	poena	NN	number=SINGULAR|gender=FEMININE|case=NOMINATIVE	
tamen	tamen	ADV	_	
praesens	praesens	ADJ	number=SINGULAR|gender=FEMININE|case=NOMINATIVE	
,			_	
cum	cum	CONJ	_	
tu	tu	PRON	number=SINGULAR|gender=MASCULINE|case=NOMINATIVE	
deponis	depono	VB	person=PERSON_2|number=SINGULAR|tense=PR|mood=INDICATIVE|voice=ACTIVE	
amictus	amictus	NN	number=PLURAL|gender=MASCULINE|case=ACCUSATIVE	
turgidus	turgidus	ADJ	number=SINGULAR|gender=MASCULINE|case=NOMINATIVE	
et	et	CONJ	_	
crudum	crudus	ADJ	number=SINGULAR|gender=MASCULINE|case=ACCUSATIVE	
pavonem	pavo	NN	number=SINGULAR|gender=MASCULINE|case=ACCUSATIVE	
in	in	PREP	_	
balnea	balneum	NN	number=PLURAL|gender=NEUTER|case=ACCUSATIVE	
portas	porto	VB	person=PERSON_2|number=SINGULAR|tense=PR|mood=INDICATIVE|voice=ACTIVE	
,			_	
quid	quis	PRON	number=SINGULAR|gender=NEUTER|case=NOMINATIVE	
enim	enim	ADV	_	
salvis	salvus	ADJ	number=PLURAL|gender=MASCULINE|case=ABLATIVE	
infamia	infamia	NN	number=SINGULAR|gender=FEMININE|case=NOMINATIVE	
nummis	nummus	NN	number=PLURAL|gender=MASCULINE|case=ABLATIVE	
Qui	qui	NN	number=SINGULAR|gender=MASCULINE|case=NOMINATIVE	
dedit	do	VB	person=PERSON_3|number=SINGULAR|tense=PERF|mood=INDICATIVE|voice=ACTIVE	
ergo	ergo	ADV	_	
tribus	tres	NRL	number=PLURAL|gender=MASCULINE|case=DATIVE	
patruis	patruus	NN	number=PLURAL|gender=MASCULINE|case=DATIVE	
aconita	aconitum	NN	number=PLURAL|gender=NEUTER|case=ACCUSATIVE	
vehatur	veho	VB	person=PERSON_3|number=SINGULAR|tense=PR|mood=SUBJUNCTIVE|voice=PASSIVE	
pensilibus	pensilis	ADJ	number=PLURAL|gender=FEMININE|case=ABLATIVE	
plumis	pluma	NN	number=PLURAL|gender=FEMININE|case=ABLATIVE	
atque	atque	CONJ	_	
illinc	illinc	ADV	_	
despiciat	despicio	VB	person=PERSON_3|number=SINGULAR|tense=PR|mood=SUBJUNCTIVE|voice=ACTIVE	
nos	nos	PRON	number=PLURAL|gender=MASCULINE|case=ACCUSATIVE	
?			_	
Haec	hic	PRON	number=PLURAL|gender=NEUTER|case=ACCUSATIVE	
ego	ego	PRON	number=SINGULAR|gender=MASCULINE|case=NOMINATIVE	
non	non	ADV	_	
credam	credo	VB	person=PERSON_1|number=SINGULAR|tense=PR|mood=SUBJUNCTIVE|voice=ACTIVE	
Venusina	venusinus	ADJ	gender=FEMININE|case=ABLATIVE	
digna	dignus	ADJ	number=PLURAL|gender=NEUTER|case=ACCUSATIVE	
lucerna	lucerna	NN	number=SINGULAR|gender=FEMININE|case=ABLATIVE	
numquam	numquam	ADV	_	
ne	ne	ADV	_	
reponam	repono	VB	person=PERSON_1|number=SINGULAR|tense=PR|mood=SUBJUNCTIVE|voice=ACTIVE	
vexatus	vexo	VB	number=SINGULAR|tense=PERF|mood=PARTICIPLE|voice=PASSIVE|gender=MASCULINE|case=NOMINATIVE	
totiens	totiens	ADV	_	
rauci	raucus	ADJ	number=SINGULAR|gender=MASCULINE|case=GENITIVE	
Theseide	Theseis	NN	number=SINGULAR|gender=MASCULINE|case=ABLATIVE	
Cordi	cordus	NN	number=SINGULAR|gender=MASCULINE|case=GENITIVE	
nam	nam	ADV	_	
lora	lorum	NN	number=PLURAL|gender=NEUTER|case=ACCUSATIVE	
tenebat	teneo	VB	person=PERSON_3|number=SINGULAR|tense=IMP|mood=INDICATIVE|voice=ACTIVE	
ipse	ipse	PRON	number=SINGULAR|gender=MASCULINE|case=NOMINATIVE	
lacernatae	lacernatus	ADJ	number=SINGULAR|gender=FEMININE|case=DATIVE	
cum	Cum	CONJ	_	
se	sui	PRON	number=SINGULAR|gender=MASCULINE|case=ACCUSATIVE	
iactaret	jacto	VB	person=PERSON_3|number=SINGULAR|tense=IMP|mood=SUBJUNCTIVE|voice=ACTIVE	
amicae	amica	NN	number=SINGULAR|gender=FEMININE|case=DATIVE	
Quid	quis	PRON	number=SINGULAR|gender=NEUTER|case=ACCUSATIVE	
agant	ago	VB	person=PERSON_3|number=PLURAL|tense=PR|mood=SUBJUNCTIVE|voice=ACTIVE	
venti	ventus	NN	number=PLURAL|gender=MASCULINE|case=NOMINATIVE	
quas	qui	ADJ	number=PLURAL|gender=FEMININE|case=ACCUSATIVE	
torqueat	torqueo	VB	person=PERSON_3|number=SINGULAR|tense=PR|mood=SUBJUNCTIVE|voice=ACTIVE	
umbras	umbra	NN	number=PLURAL|gender=FEMININE|case=ACCUSATIVE	
Aeacus	Aeacus	NN	number=SINGULAR|gender=MASCULINE|case=NOMINATIVE	
unde	unde	ADV	_	
alius	Alius	ADJ	number=SINGULAR|gender=MASCULINE|case=NOMINATIVE	
furtivae	furtivus	ADJ	number=SINGULAR|gender=FEMININE|case=GENITIVE	
devehat	deveho	VB	person=PERSON_3|number=SINGULAR|tense=PR|mood=SUBJUNCTIVE|voice=ACTIVE	
aurum	aurum	NN	number=SINGULAR|gender=NEUTER|case=ACCUSATIVE	
pelliculae	pellicula	NN	number=SINGULAR|gender=FEMININE|case=GENITIVE	
quantas	quantus	ADJ	number=PLURAL|gender=FEMININE|case=ACCUSATIVE	
iaculetur	jaculor	VB	person=PERSON_3|number=SINGULAR|tense=PR|mood=SUBJUNCTIVE|voice=PASSIVE	
Monychus	Monychus	NN	number=SINGULAR|gender=MASCULINE|case=NOMINATIVE	
ornos	ornus	NN	number=PLURAL|gender=FEMININE|case=ACCUSATIVE	
Frontonis	Fronto	NN	number=SINGULAR|gender=MASCULINE|case=GENITIVE	
platani	platanus	NN	number=PLURAL|gender=FEMININE|case=NOMINATIVE	
convulsa	convulsus	ADJ	number=PLURAL|gender=NEUTER|case=NOMINATIVE	
que	que	CONJ	_	
marmora	marmor	NN	number=PLURAL|gender=NEUTER|case=NOMINATIVE	
clamant	clamo	VB	person=PERSON_3|number=PLURAL|tense=PR|mood=INDICATIVE|voice=ACTIVE	
semper	semper	ADV	_	
et	et	CONJ	_	
adsiduo	assiduus	ADJ	number=SINGULAR|gender=MASCULINE|case=ABLATIVE	
ruptae	rumpo	VB	number=PLURAL|tense=PERF|mood=PARTICIPLE|voice=PASSIVE|gender=FEMININE|case=NOMINATIVE	
lectore	lector	NN	number=SINGULAR|gender=MASCULINE|case=ABLATIVE	
columnae	columna	NN	number=PLURAL|gender=FEMININE|case=NOMINATIVE	
Sed	sed	CONJ	_	
cum	cum	CONJ	_	
summus	summus	ADJ	number=SINGULAR|gender=MASCULINE|case=NOMINATIVE	
honor	honor	NN	number=SINGULAR|gender=MASCULINE|case=NOMINATIVE	
finito	finio	VB	number=SINGULAR|tense=PERF|mood=PARTICIPLE|voice=PASSIVE|gender=MASCULINE|case=ABLATIVE	
conputet	conputo	VB	person=PERSON_3|number=SINGULAR|tense=PR|mood=SUBJUNCTIVE|voice=ACTIVE	
anno	annus	NN	number=SINGULAR|gender=MASCULINE|case=ABLATIVE	
sportula	sportula	NN	number=SINGULAR|gender=FEMININE|case=NOMINATIVE	
quid	quis	PRON	number=SINGULAR|gender=NEUTER|case=ACCUSATIVE	
referat	refero	VB	person=PERSON_3|number=SINGULAR|tense=PR|mood=SUBJUNCTIVE|voice=ACTIVE	
quantum	quantus	ADJ	number=SINGULAR|gender=NEUTER|case=ACCUSATIVE	
rationibus	ratio	NN	number=PLURAL|gender=FEMININE|case=DATIVE	
addat	addo	VB	person=PERSON_3|number=SINGULAR|tense=PR|mood=SUBJUNCTIVE|voice=ACTIVE	
quid	quis	PRON	number=SINGULAR|gender=NEUTER|case=ACCUSATIVE	
facient	facio	VB	person=PERSON_3|number=PLURAL|tense=FUTURE|mood=INDICATIVE|voice=ACTIVE	
comites	comes	NN	number=PLURAL|gender=MASCULINE|case=NOMINATIVE	
quibus	qui	PRON	number=PLURAL|gender=MASCULINE|case=DATIVE	
hinc	hinc	ADV	_	
toga	toga	NN	number=SINGULAR|gender=FEMININE|case=NOMINATIVE	
calceus	calceus	NN	number=SINGULAR|gender=MASCULINE|case=NOMINATIVE	
hinc	hinc	ADV	_	
est	sum	VB	person=PERSON_3|number=SINGULAR|tense=PR|mood=INDICATIVE|voice=ACTIVE	
et	et	CONJ	_	
panis	panis	NN	number=SINGULAR|gender=MASCULINE|case=NOMINATIVE	
fumus	fumus	NN	number=SINGULAR|gender=MASCULINE|case=NOMINATIVE	
-que	que	CONJ	_	
domi	domus	NN	number=SINGULAR|gender=FEMININE|case=LOCATIVE	
haec	hic	ADJ	number=PLURAL|gender=NEUTER|case=ACCUSATIVE	
ego	ego	PRON	number=SINGULAR|gender=MASCULINE|case=NOMINATIVE	
non	non	ADV	_	
agitem	agito	VB	person=PERSON_1|number=SINGULAR|tense=PR|mood=SUBJUNCTIVE|voice=ACTIVE	
Galla	Galla	NN	number=SINGULAR|gender=FEMININE|case=NOMINATIVE	
mea	meus	ADJ	number=SINGULAR|gender=FEMININE|case=NOMINATIVE	
est	sum	VB	person=PERSON_3|number=SINGULAR|tense=PR|mood=INDICATIVE|voice=ACTIVE	
inquit	inquam	VB	person=PERSON_3|number=SINGULAR|tense=PR|mood=INDICATIVE|voice=ACTIVE	
,	comma	CONJ	_	
citius	cieo	ADV	_	
dimitte	dimitto	VB	person=PERSON_2|number=SINGULAR|tense=PR|mood=IMPERATIVE|voice=ACTIVE	
et	et	ADV	_	
quando	quando	ADV	_	
uberior	uber	ADJ	number=SINGULAR|gender=FEMININE|case=NOMINATIVE|degree=COMPARATIVE	
vitiorum	vitium	NN	number=PLURAL|gender=NEUTER|case=GENITIVE	
copia	copia	NN	number=SINGULAR|gender=FEMININE|case=NOMINATIVE	
ducitur	duco	VB	person=PERSON_3|number=SINGULAR|tense=PR|mood=INDICATIVE|voice=PASSIVE	
iratis	irascor	VB	number=PLURAL|tense=PERF|mood=PARTICIPLE|voice=PASSIVE|gender=MASCULINE|case=DATIVE	
plaudendum	plaudo	VB	number=SINGULAR|mood=GERUNDIVE|gender=NEUTER|case=NOMINATIVE	
funus	funus	NN	number=SINGULAR|gender=NEUTER|case=NOMINATIVE	
amicis	amicus	NN	number=PLURAL|gender=MASCULINE|case=DATIVE	
.			_	
te	tu	PRON	number=SINGULAR|gender=MASCULINE|case=ABLATIVE	
-cum	cum	PREP	_	
prius	prior	ADJ	number=SINGULAR|gender=NEUTER|case=ACCUSATIVE|degree=COMPARATIVE	
ergo	ergo	ADV	_	
voluta	voluto	VB	person=PERSON_2|number=SINGULAR|tense=PR|mood=IMPERATIVE|voice=ACTIVE	
haec	hic	PRON	number=PLURAL|gender=NEUTER|case=ACCUSATIVE	
animo	animus	NN	number=SINGULAR|gender=MASCULINE|case=ABLATIVE	
ante	ante	PREP	_	
tubas	tuba	NN	number=PLURAL|gender=FEMININE|case=ACCUSATIVE	
:			_	
iubet	jubeo	VB	person=PERSON_3|number=SINGULAR|tense=PR|mood=INDICATIVE|voice=ACTIVE	
a	ab	PREP	_	
praecone	praeco	NN	number=SINGULAR|gender=MASCULINE|case=ABLATIVE	
vocari	voco	VB	tense=PR|mood=INFINITIVE|voice=PASSIVE	
ipsos	ipse	PRON	number=PLURAL|gender=MASCULINE|case=ACCUSATIVE	
Troiugenas	Trojugena	NN	number=PLURAL|gender=MASCULINE|case=ACCUSATIVE	
,	unknown		_	
nam	nam	ADV	_	
vexant	vexo	VB	person=PERSON_3|number=PLURAL|tense=PR|mood=INDICATIVE|voice=ACTIVE	
limen	limen	NN	number=SINGULAR|gender=NEUTER|case=ACCUSATIVE	
et	et	ADV	_	
ipsi	ipse	PRON	number=PLURAL|gender=MASCULINE|case=NOMINATIVE	
nobis	nos	PRON	number=PLURAL|gender=MASCULINE|case=ABLATIVE	
-cum	cum	PREP	_	
inde	inde	ADV	_	
ira	ira	NN	number=SINGULAR|gender=FEMININE|case=NOMINATIVE	
et	et	CONJ	_	
lacrimae	lacrima	NN	number=PLURAL|gender=FEMININE|case=NOMINATIVE	
da	do	VB	person=PERSON_2|number=SINGULAR|tense=PR|mood=IMPERATIVE|voice=ACTIVE	
praetori	praetor	NN	number=SINGULAR|gender=MASCULINE|case=DATIVE	
da	do	VB	person=PERSON_2|number=SINGULAR|tense=PR|mood=IMPERATIVE|voice=ACTIVE	
deinde	deinde	ADV	_	
tribuno	tribunus	NN	number=SINGULAR|gender=MASCULINE|case=DATIVE	
simplex	simplex	ADJ	number=SINGULAR|gender=MASCULINE|case=NOMINATIVE	
ne	ne	ADV	_	
furor	furor	NN	number=SINGULAR|gender=MASCULINE|case=NOMINATIVE	
sestertia	sestertium	NN	number=PLURAL|gender=NEUTER|case=ACCUSATIVE	
centum	centum	NRL	_	
perdere	perdo	VB	tense=PR|mood=INFINITIVE|voice=ACTIVE	
et	et	CONJ	_	
horrenti	horreo	VB	number=SINGULAR|tense=PR|mood=PARTICIPLE|gender=MASCULINE|case=DATIVE	
tunicam	tunica	NN	number=SINGULAR|gender=FEMININE|case=ACCUSATIVE	
non	non	ADV	_	
reddere	reddo	VB	tense=PR|mood=INFINITIVE|voice=ACTIVE	
servo	servus	NN	number=SINGULAR|gender=MASCULINE|case=DATIVE	
hinc	hinc	ADV	_	
subitae	subitus	ADJ	number=PLURAL|gender=FEMININE|case=NOMINATIVE	
mortes	mors	NN	number=PLURAL|gender=FEMININE|case=NOMINATIVE	
atque	atque	CONJ	_	
intestata	intestatus	ADJ	number=SINGULAR|gender=FEMININE|case=NOMINATIVE	
senectus	senectus	NN	number=SINGULAR|gender=FEMININE|case=NOMINATIVE	
sed	sed	CONJ	_	
libertinus	libertinus	ADJ	number=SINGULAR|gender=MASCULINE|case=NOMINATIVE	
prior	prior	ADJ	number=SINGULAR|gender=MASCULINE|case=NOMINATIVE|degree=COMPARATIVE	
est	sum	VB	person=PERSON_3|number=SINGULAR|tense=PR|mood=INDICATIVE|voice=ACTIVE	
Ex	ex	PREP	_	
quo	quis	ADJ	number=SINGULAR|gender=NEUTER|case=ABLATIVE	
Deucalion	Deucalion	NN	number=SINGULAR|gender=MASCULINE|case=NOMINATIVE	
nimbis	nimbus	NN	number=PLURAL|gender=MASCULINE|case=ABLATIVE	
tollentibus	tollo	VB	number=PLURAL|tense=PR|mood=PARTICIPLE|gender=MASCULINE|case=ABLATIVE	
aequor	aequor	NN	number=SINGULAR|gender=NEUTER|case=ACCUSATIVE	
navigio	navigium	NN	number=SINGULAR|gender=NEUTER|case=ABLATIVE	
montem	mons	NN	number=SINGULAR|gender=MASCULINE|case=ACCUSATIVE	
ascendit	ascendo	VB	person=PERSON_3|number=SINGULAR|tense=PR|mood=INDICATIVE|voice=ACTIVE	
sortes	sors	NN	number=PLURAL|gender=FEMININE|case=ACCUSATIVE	
que	que	CONJ	_	
poposcit	posco	VB	person=PERSON_3|number=SINGULAR|tense=PERF|mood=INDICATIVE|voice=ACTIVE	
paulatim	paulatim	ADV	_	
que	que	CONJ	_	
anima	anima	NN	number=SINGULAR|gender=FEMININE|case=ABLATIVE	
caluerunt	caleo	VB	person=PERSON_3|number=PLURAL|tense=PERF|mood=INDICATIVE|voice=ACTIVE	
mollia	mollis	ADJ	number=PLURAL|gender=NEUTER|case=NOMINATIVE	
saxa	saxum	NN	number=PLURAL|gender=NEUTER|case=NOMINATIVE	
et	et	CONJ	_	
maribus	mare	NN	number=PLURAL|gender=NEUTER|case=DATIVE	
nudas	nudus	ADJ	number=PLURAL|gender=FEMININE|case=ACCUSATIVE	
ostendit	ostendo	VB	person=PERSON_3|number=SINGULAR|tense=PERF|mood=INDICATIVE|voice=ACTIVE	
Pyrrha	Pyrrha	NN	number=SINGULAR|gender=FEMININE|case=NOMINATIVE	
puellas	puella	NN	number=PLURAL|gender=FEMININE|case=ACCUSATIVE	
quidquid	quisquis	PRON	number=SINGULAR|gender=NEUTER|case=ACCUSATIVE	
agunt	ago	VB	person=PERSON_3|number=PLURAL|tense=PR|mood=INDICATIVE|voice=ACTIVE	
homines	homo	NN	number=PLURAL|gender=MASCULINE|case=NOMINATIVE	
,	comma	CONJ	_	
votum	votum	NN	number=SINGULAR|gender=NEUTER|case=NOMINATIVE	
timor	timor	NN	number=SINGULAR|gender=MASCULINE|case=NOMINATIVE	
ira	ira	NN	number=SINGULAR|gender=FEMININE|case=NOMINATIVE	
voluptas	voluptas	NN	number=SINGULAR|gender=FEMININE|case=NOMINATIVE	
gaudia	gaudium	NN	number=PLURAL|gender=NEUTER|case=NOMINATIVE	
discursus	discursus	NN	number=PLURAL|gender=MASCULINE|case=NOMINATIVE	
nostri	noster	ADJ	number=SINGULAR|gender=MASCULINE|case=GENITIVE	
farrago	farrago	NN	number=SINGULAR|gender=FEMININE|case=NOMINATIVE	
libelli	libellus	NN	number=SINGULAR|gender=MASCULINE|case=GENITIVE	
est	sum	VB	person=PERSON_3|number=SINGULAR|tense=PR|mood=INDICATIVE|voice=ACTIVE	
ne	ne	ADV	_	
-que	que	CONJ	_	
enim	enim	CONJ	_	
loculis	loculus	NN	number=PLURAL|gender=MASCULINE|case=ABLATIVE	
comitantibus	comitor	VB	number=PLURAL|tense=PR|mood=PARTICIPLE|gender=MASCULINE|case=ABLATIVE	
itur	eo	VB	person=PERSON_3|number=SINGULAR|tense=PR|mood=INDICATIVE|voice=PASSIVE	
ad	ad	PREP	_	
casum	casus	NN	number=SINGULAR|gender=MASCULINE|case=ACCUSATIVE	
tabulae	tabula	NN	number=SINGULAR|gender=FEMININE|case=GENITIVE	
posita	pono	VB	number=SINGULAR|tense=PERF|mood=PARTICIPLE|voice=PASSIVE|gender=FEMININE|case=ABLATIVE	
sed	sed	CONJ	_	
luditur	ludo	VB	person=PERSON_3|number=SINGULAR|tense=PR|mood=INDICATIVE|voice=PASSIVE	
arca	arca	NN	number=SINGULAR|gender=FEMININE|case=ABLATIVE	
exul	exsul	NN	number=SINGULAR|gender=MASCULINE|case=NOMINATIVE	
ab	ab	PREP	_	
octava	octavus	ADJ	number=SINGULAR|gender=FEMININE|case=ABLATIVE	
Marius	Marius	NN	number=SINGULAR|gender=MASCULINE|case=NOMINATIVE	
bibit	bibo	VB	person=PERSON_3|number=SINGULAR|tense=PR|mood=INDICATIVE|voice=ACTIVE	
et	et	CONJ	_	
fruitur	fruor	VB	person=PERSON_3|number=SINGULAR|tense=PR|mood=INDICATIVE|voice=PASSIVE	
dis	deus	ADJ	number=PLURAL|gender=MASCULINE|case=ABLATIVE	
iratis	irascor		number=PLURAL|tense=PERF|mood=PARTICIPLE|voice=PASSIVE|gender=MASCULINE|case=ABLATIVE	
,	unknown		_	
at	at	CONJ	_	
tu	tu	PRON	number=SINGULAR|gender=FEMININE|case=VOCATIVE	
victrix	victrix	NN	number=SINGULAR|gender=FEMININE|case=VOCATIVE	
provincia	provincia	NN	number=SINGULAR|gender=FEMININE|case=VOCATIVE	
ploras	ploro	VB	person=PERSON_2|number=SINGULAR|tense=PR|mood=INDICATIVE|voice=ACTIVE	
.	unknown		_	
quid	quis	PRON	number=SINGULAR|gender=NEUTER|case=ACCUSATIVE	
confert	confero	VB	person=PERSON_3|number=SINGULAR|tense=PR|mood=INDICATIVE|voice=ACTIVE	
purpura	purpura	NN	number=SINGULAR|gender=FEMININE|case=NOMINATIVE	
maior	magnus	ADJ	number=SINGULAR|gender=FEMININE|case=NOMINATIVE|degree=COMPARATIVE	
optandum	opto	VB	number=SINGULAR|mood=GERUNDIVE|gender=NEUTER|case=ACCUSATIVE	
si	si	CONJ	_	
Laurenti	Laurentum	NN	number=SINGULAR|gender=NEUTER|case=GENITIVE	
custodit	custodio	VB	person=PERSON_3|number=SINGULAR|tense=PR|mood=INDICATIVE|voice=ACTIVE	
in	in	PREP	_	
agro	ager	NN	number=SINGULAR|gender=MASCULINE|case=ABLATIVE	
conductas	conduco	VB	number=PLURAL|tense=PERF|mood=PARTICIPLE|voice=PASSIVE|gender=FEMININE|case=ACCUSATIVE	
Corvinus	corvinus	NN	number=SINGULAR|gender=MASCULINE|case=NOMINATIVE	
oves	ovis	NN	number=PLURAL|gender=FEMININE|case=ACCUSATIVE	
,	comma	CONJ	_	
ego	ego	PRON	number=SINGULAR|gender=MASCULINE|case=NOMINATIVE	
possideo	possideo	VB	person=PERSON_1|number=SINGULAR|tense=PR|mood=INDICATIVE|voice=ACTIVE	
plus	multus	ADJ	number=SINGULAR|gender=NEUTER|case=ACCUSATIVE|degree=COMPARATIVE	
Pallante	Pallas	NN	number=SINGULAR|gender=MASCULINE|case=ABLATIVE	
et	et	CONJ	_	
Licinis	Licinus	NN	number=PLURAL|gender=MASCULINE|case=ABLATIVE	
quanta	quantus	ADJ	number=SINGULAR|gender=FEMININE|case=NOMINATIVE	
est	sum	VB	person=PERSON_3|number=SINGULAR|tense=PR|mood=INDICATIVE|voice=ACTIVE	
gula	gula	NN	number=SINGULAR|gender=FEMININE|case=NOMINATIVE	
quae	qui	PRON	number=SINGULAR|gender=FEMININE|case=NOMINATIVE	
sibi	sui	PRON	number=PLURAL|gender=FEMININE|case=DATIVE	
totos	totus	ADJ	number=PLURAL|gender=MASCULINE|case=ACCUSATIVE	
ponit	pono	VB	person=PERSON_3|number=SINGULAR|tense=PR|mood=INDICATIVE|voice=ACTIVE	
apros	aper	NN	number=PLURAL|gender=MASCULINE|case=ACCUSATIVE	
,			_	
animal	animal	NN	number=SINGULAR|gender=NEUTER|case=ACCUSATIVE	
propter	propter	PREP	_	
convivia	convivium	NN	number=PLURAL|gender=NEUTER|case=ACCUSATIVE	
natum	nascor	VB	number=SINGULAR|tense=PERF|mood=PARTICIPLE|voice=DEPONENS|gender=NEUTER|case=ACCUSATIVE|degree=POSITIVE	
!			_	
et	et	ADV	_	
nos	nos	PRON	number=PLURAL|gender=MASCULINE|case=NOMINATIVE	
ergo	ergo	ADV	_	
manum	manus	NN	number=SINGULAR|gender=FEMININE|case=ACCUSATIVE	
ferulae	ferula	NN	number=SINGULAR|gender=FEMININE|case=DATIVE	
subduximus	subduco	VB	person=PERSON_1|number=PLURAL|tense=PERF|mood=INDICATIVE|voice=ACTIVE	
,	unknown		_	
et	et	ADV	_	
nos	nos	PRON	number=PLURAL|gender=MASCULINE|case=NOMINATIVE	
consilium	consilium	NN	number=SINGULAR|gender=NEUTER|case=ACCUSATIVE	
dedimus	do	VB	person=PERSON_1|number=PLURAL|tense=PERF|mood=INDICATIVE|voice=ACTIVE	
Sullae	Sulla	NN	number=SINGULAR|gender=MASCULINE|case=DATIVE	
,	unknown		_	
privatus	privatus	NN	number=SINGULAR|gender=MASCULINE|case=NOMINATIVE	
ut	ut	ADV	_	
altum	altus	ADJ	number=SINGULAR|gender=NEUTER|case=ACCUSATIVE	
dormiret	dormio	VB	person=PERSON_3|number=SINGULAR|tense=IMP|mood=SUBJUNCTIVE|voice=ACTIVE	
vestibulis	vestibulum	NN	number=PLURAL|gender=NEUTER|case=ABLATIVE	
abeunt	abeo	VB	person=PERSON_3|number=PLURAL|tense=PR|mood=INDICATIVE|voice=ACTIVE	
veteres	vetus	ADJ	number=PLURAL|gender=MASCULINE|case=NOMINATIVE	
lassi	lassus	ADJ	number=PLURAL|gender=MASCULINE|case=NOMINATIVE	
-que	que	CONJ	_	
clientes	cliens	NN	number=PLURAL|gender=MASCULINE|case=NOMINATIVE	
vota	votum	NN	number=PLURAL|gender=NEUTER|case=ACCUSATIVE	
-que	que	CONJ	_	
deponunt	depono	VB	person=PERSON_3|number=PLURAL|tense=PR|mood=INDICATIVE|voice=ACTIVE	
,			_	
quamquam	quamquam	CONJ	_	
longissima	longus	ADJ	number=SINGULAR|gender=FEMININE|case=NOMINATIVE|degree=SUPERLATIVE	
cenae	cena	NN	number=SINGULAR|gender=FEMININE|case=GENITIVE	
spes	spes	NN	number=SINGULAR|gender=FEMININE|case=NOMINATIVE	
homini	homo	NN	number=SINGULAR|gender=MASCULINE|case=DATIVE	
Semper	semper	ADV	_	
ego	ego	PRON	number=SINGULAR|gender=MASCULINE|case=NOMINATIVE	
auditor	auditor	NN	number=SINGULAR|gender=MASCULINE|case=NOMINATIVE	
tantum	tantus	ADV	_	
sportula	sportula	NN	number=SINGULAR|gender=FEMININE|case=NOMINATIVE	
,			_	
deinde	deinde	ADV	_	
forum	forum	NN	number=SINGULAR|gender=NEUTER|case=NOMINATIVE	
iuris	jus	NN	number=SINGULAR|gender=NEUTER|case=GENITIVE	
-que	que	CONJ	_	
peritus	peritus	ADJ	number=SINGULAR|gender=MASCULINE|case=NOMINATIVE	
Apollo	Apollo	NN	number=SINGULAR|gender=MASCULINE|case=NOMINATIVE	
atque	atque	CONJ	_	
triumphales	triumphalis	ADJ	number=PLURAL|gender=FEMININE|case=NOMINATIVE	
,			_	
inter	inter	PREP	_	
quas	qui	PRON	number=PLURAL|gender=FEMININE|case=ACCUSATIVE	
ausus	audeo	VB	number=SINGULAR|tense=PERF|mood=PARTICIPLE|voice=DEPONENS|gender=MASCULINE|case=NOMINATIVE|degree=POSITIVE	
habere	habeo	VB	tense=PR|mood=INFINITIVE|voice=ACTIVE	
nescio	nescio	VB	person=PERSON_1|number=SINGULAR|tense=PR|mood=INDICATIVE|voice=ACTIVE	
quis	quis	PRON	number=SINGULAR|gender=MASCULINE|case=NOMINATIVE	
titulos	titulus	NN	number=PLURAL|gender=MASCULINE|case=ACCUSATIVE	
Aegyptius	Aegyptius	ADJ	number=SINGULAR|gender=MASCULINE|case=NOMINATIVE|degree=POSITIVE	
atque	atque	CONJ	_	
Arabarches	arabarches	NN	number=SINGULAR|gender=MASCULINE|case=NOMINATIVE	
,			_	
cuius	qui	NN	number=SINGULAR|gender=MASCULINE|case=GENITIVE	
ad	ad	PREP	_	
effigiem	effigies	NN	number=SINGULAR|gender=FEMININE|case=ACCUSATIVE	
non	non	ADV	_	
tantum	tantus	ADJ	number=SINGULAR|gender=NEUTER|case=ACCUSATIVE	
meiere	meio	VB	number=SINGULAR|tense=PR|mood=INFINITIVE|voice=ACTIVE	
fas	fas	ADJ	number=SINGULAR|gender=NEUTER|case=NOMINATIVE|degree=POSITIVE	
est	sum	VB	person=PERSON_3|number=SINGULAR|tense=PR|mood=INDICATIVE|voice=ACTIVE	
quis	quis	PRON	number=SINGULAR|gender=MASCULINE|case=NOMINATIVE	
totidem	totidem	ADV	_	
erexit	erigo	VB	person=PERSON_3|number=SINGULAR|tense=PERF|mood=INDICATIVE|voice=ACTIVE	
villas	villa	NN	number=PLURAL|gender=FEMININE|case=ACCUSATIVE	
,	comma	CONJ	_	
quis	quis	PRON	number=SINGULAR|gender=MASCULINE|case=NOMINATIVE	
fercula	ferculum	NN	number=PLURAL|gender=NEUTER|case=ACCUSATIVE	
septem	septem	NRL	_	
secreto	secretum	ADV	_	
cenavit	ceno	VB	person=PERSON_3|number=SINGULAR|tense=PERF|mood=INDICATIVE|voice=ACTIVE	
avus	avus	NN	number=SINGULAR|gender=MASCULINE|case=NOMINATIVE	
stulta	stultus	ADJ	number=SINGULAR|gender=FEMININE|case=NOMINATIVE	
est	sum	VB	person=PERSON_3|number=SINGULAR|tense=PR|mood=INDICATIVE|voice=ACTIVE	
clementia	clementia	NN	number=SINGULAR|gender=FEMININE|case=NOMINATIVE	
,	unknown		_	
cum	Cum	CONJ	_	
tot	tot	ADV	_	
ubique	ubique	ADV	_	
vatibus	vates	NN	number=PLURAL|gender=MASCULINE|case=DATIVE	
occurras	occurro	VB	person=PERSON_2|number=SINGULAR|tense=PR|mood=SUBJUNCTIVE|voice=ACTIVE	
,	unknown		_	
periturae	pereo	VB	number=SINGULAR|tense=FUTURE|mood=PARTICIPLE|voice=ACTIVE|gender=FEMININE|case=DATIVE	
parcere	parco	VB	tense=PR|mood=INFINITIVE|voice=ACTIVE	
chartae	charta	NN	number=SINGULAR|gender=FEMININE|case=DATIVE	
expectes	exspecto	VB	person=PERSON_2|number=SINGULAR|tense=PR|mood=SUBJUNCTIVE|voice=ACTIVE	
eadem	idem	PRON	number=PLURAL|gender=NEUTER|case=ACCUSATIVE	
a	ab	PREP	_	
summo	summus	ADJ	number=SINGULAR|gender=MASCULINE|case=ABLATIVE	
minimo	parvus	ADJ	number=SINGULAR|gender=MASCULINE|case=ABLATIVE	
que	que	CONJ	_	
poeta	poeta	NN	number=SINGULAR|gender=MASCULINE|case=ABLATIVE	
.	unknown		_	
moraris	moror	VB	person=PERSON_2|number=SINGULAR|tense=PR|mood=INDICATIVE|voice=PASSIVE	
pone	pono	VB	person=PERSON_2|number=SINGULAR|tense=PR|mood=IMPERATIVE|voice=ACTIVE	
Tigellinum	Tigellinus	NN	number=SINGULAR|gender=MASCULINE|case=ACCUSATIVE	
Ipse	ipse	PRON	number=SINGULAR|gender=MASCULINE|case=NOMINATIVE	
dies	dies	NN	number=SINGULAR|gender=MASCULINE|case=NOMINATIVE	
pulchro	pulcher	ADJ	number=SINGULAR|gender=MASCULINE|case=ABLATIVE	
distinguitur	distinguo	VB	person=PERSON_3|number=SINGULAR|tense=PR|mood=INDICATIVE|voice=PASSIVE	
ordine	ordo	NN	number=SINGULAR|gender=MASCULINE|case=ABLATIVE	
rerum	res	NN	number=PLURAL|gender=FEMININE|case=GENITIVE	
:			_	
nullus	nullus	ADJ	number=SINGULAR|gender=MASCULINE|case=NOMINATIVE	
iam	jam	ADV	_	
parasitus	parasitus	NN	number=SINGULAR|gender=MASCULINE|case=NOMINATIVE	
erit	sum	VB	person=PERSON_3|number=SINGULAR|tense=FUTURE|mood=INDICATIVE|voice=ACTIVE	
sed	sed	CONJ	_	
quid	quis	NN	number=SINGULAR|gender=NEUTER|case=ACCUSATIVE	
magis	magis	ADV	_	
inpune	impune	ADV	_	
ergo	ergo	ADV	_	
mihi	ego	PRON	number=SINGULAR|gender=MASCULINE|case=DATIVE	
recitaverit	recito	VB	person=PERSON_3|number=SINGULAR|tense=FUTUREPERFECT|mood=INDICATIVE|voice=ACTIVE	
ille	ille	PRON	number=SINGULAR|gender=MASCULINE|case=NOMINATIVE	
togatas	togata	NN	number=PLURAL|gender=FEMININE|case=ACCUSATIVE	
,	comma	CONJ	_	
hic	hic	PRON	number=SINGULAR|gender=MASCULINE|case=NOMINATIVE	
elegos	elegi	NN	number=PLURAL|gender=MASCULINE|case=ACCUSATIVE	
ense	ensis	NN	number=SINGULAR|gender=MASCULINE|case=ABLATIVE	
velut	velut	ADV	_	
stricto	stringo	VB	number=SINGULAR|tense=PERF|mood=PARTICIPLE|voice=PASSIVE|gender=MASCULINE|case=ABLATIVE	
quotiens	quotiens	ADV	_	
Lucilius	Lucilius	NN	number=SINGULAR|gender=MASCULINE|case=NOMINATIVE	
ardens	ardeo	VB	number=SINGULAR|tense=PR|mood=PARTICIPLE|gender=MASCULINE|case=NOMINATIVE	
infremuit	infremo	VB	person=PERSON_3|number=SINGULAR|tense=PERF|mood=INDICATIVE|voice=ACTIVE	
rubet	rubeo	VB	person=PERSON_3|number=SINGULAR|tense=PR|mood=INDICATIVE|voice=ACTIVE	
auditor	auditor	NN	number=SINGULAR|gender=MASCULINE|case=NOMINATIVE	
cui	quis	NN	number=SINGULAR|gender=MASCULINE|case=DATIVE	
frigida	frigidus	ADJ	number=SINGULAR|gender=FEMININE|case=NOMINATIVE	
mens	mens	NN	number=SINGULAR|gender=FEMININE|case=NOMINATIVE	
est	sum	VB	person=PERSON_3|number=SINGULAR|tense=PR|mood=INDICATIVE|voice=ACTIVE	
criminibus	crimen	NN	number=PLURAL|gender=NEUTER|case=ABLATIVE	
tacita	taceo	VB	number=PLURAL|tense=PERF|mood=PARTICIPLE|voice=PASSIVE|gender=NEUTER|case=NOMINATIVE	
sudant	sudo	VB	person=PERSON_3|number=PLURAL|tense=PR|mood=INDICATIVE|voice=ACTIVE	
praecordia	praecordia	NN	number=PLURAL|gender=NEUTER|case=NOMINATIVE	
culpa	culpa	NN	number=SINGULAR|gender=FEMININE|case=ABLATIVE	
Quid	quis	PRON	number=SINGULAR|gender=NEUTER|case=ACCUSATIVE	
referam	refero	VB	person=PERSON_1|number=SINGULAR|tense=PR|mood=SUBJUNCTIVE|voice=ACTIVE	
quanta	quantus	ADJ	number=SINGULAR|gender=FEMININE|case=ABLATIVE	
siccum	siccus	ADJ	number=SINGULAR|gender=NEUTER|case=NOMINATIVE	
iecur	iecur	NN	number=SINGULAR|gender=NEUTER|case=NOMINATIVE	
ardeat	ardeo	VB	person=PERSON_3|number=SINGULAR|tense=PR|mood=SUBJUNCTIVE|voice=ACTIVE	
ira	ira	NN	number=SINGULAR|gender=FEMININE|case=ABLATIVE	
cum	Cum	CONJ	_	
populum	populus	NN	number=SINGULAR|gender=MASCULINE|case=ACCUSATIVE	
gregibus	grex	NN	number=PLURAL|gender=MASCULINE|case=ABLATIVE	
comitum	comes	NN	number=PLURAL|gender=MASCULINE|case=GENITIVE	
premit	premo	VB	person=PERSON_3|number=SINGULAR|tense=PR|mood=INDICATIVE|voice=ACTIVE	
hic	hic	PRON	number=SINGULAR|gender=MASCULINE|case=NOMINATIVE	
spoliator	spoliator	NN	number=SINGULAR|gender=MASCULINE|case=NOMINATIVE	
pupilli	pupillus	NN	number=SINGULAR|gender=MASCULINE|case=GENITIVE	
prostantis	prosto	VB	number=SINGULAR|tense=PR|mood=PARTICIPLE|gender=MASCULINE|case=GENITIVE	
et	et	CONJ	_	
hic	hic	PRON	number=SINGULAR|gender=MASCULINE|case=NOMINATIVE	
damnatus	damno	VB	number=SINGULAR|tense=PERF|mood=PARTICIPLE|voice=PASSIVE|gender=MASCULINE|case=NOMINATIVE	
inani	inanis	ADJ	number=SINGULAR|gender=NEUTER|case=ABLATIVE	
iudicio	judicium	NN	number=SINGULAR|gender=NEUTER|case=ABLATIVE	
proelia	proelium	NN	number=PLURAL|gender=NEUTER|case=ACCUSATIVE	
quanta	quantus	ADJ	number=PLURAL|gender=NEUTER|case=ACCUSATIVE	
illic	illic	ADV	_	
dispensatore	dispensator	NN	number=SINGULAR|gender=MASCULINE|case=ABLATIVE	
videbis	video	VB	person=PERSON_2|number=SINGULAR|tense=FUTURE|mood=INDICATIVE|voice=ACTIVE	
armigero	armiger	ADJ	number=SINGULAR|gender=MASCULINE|case=ABLATIVE	
!	unknown		_	
quem	quis	PRON	number=SINGULAR|gender=MASCULINE|case=ACCUSATIVE	
patitur	patior	VB	person=PERSON_3|number=SINGULAR|tense=PR|mood=INDICATIVE|voice=PASSIVE	
dormire	dormio	VB	tense=PR|mood=INFINITIVE|voice=ACTIVE	
nurus	nurus	NN	number=SINGULAR|gender=FEMININE|case=GENITIVE	
corruptor	corruptor	NN	number=SINGULAR|gender=MASCULINE|case=NOMINATIVE	
avarae	avarus	ADJ	number=SINGULAR|gender=FEMININE|case=GENITIVE	
,	comma	CONJ	_	
quem	quis	PRON	number=SINGULAR|gender=MASCULINE|case=ACCUSATIVE	
sponsae	sponsa	NN	number=PLURAL|gender=FEMININE|case=NOMINATIVE	
turpes	turpis	ADJ	number=PLURAL|gender=FEMININE|case=NOMINATIVE	
et	et	CONJ	_	
praetextatus	praetextatus	ADJ	number=SINGULAR|gender=MASCULINE|case=NOMINATIVE	
adulter	adulter	ADJ	number=SINGULAR|gender=MASCULINE|case=NOMINATIVE	
Nil	Nihil	NN	number=SINGULAR|gender=NEUTER|case=NOMINATIVE	
erit	sum	VB	person=PERSON_3|number=SINGULAR|tense=FUTURE|mood=INDICATIVE|voice=ACTIVE	
ulterius	ulterior	ADJ	number=SINGULAR|gender=NEUTER|case=NOMINATIVE|degree=COMPARATIVE	
quod	qui	PRON	number=SINGULAR|gender=NEUTER|case=ACCUSATIVE	
nostris	noster	ADJ	number=PLURAL|gender=MASCULINE|case=DATIVE	
moribus	mos	NN	number=PLURAL|gender=MASCULINE|case=DATIVE	
addat	addo	VB	person=PERSON_3|number=SINGULAR|tense=PR|mood=SUBJUNCTIVE|voice=ACTIVE	
posteritas	posteritas	NN	number=SINGULAR|gender=FEMININE|case=NOMINATIVE	
eadem	idem	PRON	number=PLURAL|gender=NEUTER|case=ACCUSATIVE	
facient	facio	VB	person=PERSON_3|number=PLURAL|tense=FUTURE|mood=INDICATIVE|voice=ACTIVE	
cupient	cupio	VB	person=PERSON_3|number=PLURAL|tense=FUTURE|mood=INDICATIVE|voice=ACTIVE	
-que	que	CONJ	_	
minores	parvus	ADJ	number=PLURAL|gender=MASCULINE|case=NOMINATIVE|degree=COMPARATIVE	
omne	omnis	ADJ	number=SINGULAR|gender=NEUTER|case=NOMINATIVE	
in	in	PREP	_	
praecipiti	praeceps	NN	number=SINGULAR|gender=NEUTER|case=ABLATIVE	
vitium	vitium	NN	number=SINGULAR|gender=NEUTER|case=NOMINATIVE	
stetit	sto	VB	person=PERSON_3|number=SINGULAR|tense=PERF|mood=INDICATIVE|voice=ACTIVE	
.			_	
Heracleas	Heraclea	NN	number=PLURAL|gender=FEMININE|case=ACCUSATIVE	
aut	aut	CONJ	_	
Diomedeas	Diomedea	NN	number=PLURAL|gender=FEMININE|case=ACCUSATIVE	
aut	aut	CONJ	_	
mugitum	mugitus	NN	number=SINGULAR|gender=MASCULINE|case=ACCUSATIVE	
labyrinthi	labyrinthus	NN	number=SINGULAR|gender=MASCULINE|case=GENITIVE	
et	et	CONJ	_	
mare	mare	NN	number=SINGULAR|gender=NEUTER|case=ACCUSATIVE	
percussum	percutio	VB	number=SINGULAR|tense=PERF|mood=PARTICIPLE|voice=PASSIVE|gender=NEUTER|case=ACCUSATIVE	
puero	puer	NN	number=SINGULAR|gender=MASCULINE|case=ABLATIVE	
fabrum	faber	NN	number=SINGULAR|gender=MASCULINE|case=ACCUSATIVE	
-que	que	CONJ	_	
uolantem	volo	VB	number=SINGULAR|tense=PR|mood=PARTICIPLE|gender=MASCULINE|case=ACCUSATIVE	
cum	cum	CONJ	_	
leno	leno	NN	number=SINGULAR|gender=MASCULINE|case=NOMINATIVE	
accipiat	accipio	VB	person=PERSON_3|number=SINGULAR|tense=PR|mood=SUBJUNCTIVE|voice=ACTIVE	
moechi	moechus	NN	number=SINGULAR|gender=MASCULINE|case=GENITIVE	
bona	bonum	NN	number=PLURAL|gender=NEUTER|case=ACCUSATIVE	
si	si	CONJ	_	
capiendi	capio	VB	number=SINGULAR|mood=GERUNDIVE|gender=NEUTER|case=GENITIVE	
ius	jus	NN	number=SINGULAR|gender=NEUTER|case=NOMINATIVE	
nullum	nullus	ADJ	number=SINGULAR|gender=NEUTER|case=NOMINATIVE	
uxori	uxor	NN	number=SINGULAR|gender=FEMININE|case=DATIVE	
doctus	doceo	VB	number=SINGULAR|tense=PERF|mood=PARTICIPLE|voice=PASSIVE|gender=MASCULINE|case=NOMINATIVE	
spectare	specto	VB	tense=PR|mood=INFINITIVE|voice=ACTIVE	
lacunar			_	
doctus	doceo	VB	number=SINGULAR|tense=PERF|mood=PARTICIPLE|voice=PASSIVE|gender=MASCULINE|case=NOMINATIVE	
et	et	CONJ	_	
ad	ad	PREP	_	
calicem	calix	NN	number=SINGULAR|gender=MASCULINE|case=ACCUSATIVE	
uigilanti	vigilo	VB	number=SINGULAR|tense=PR|mood=PARTICIPLE|gender=MASCULINE|case=ABLATIVE	
stertere	sterto	VB	tense=PR|mood=INFINITIVE|voice=ACTIVE	
naso	nasus	NN	number=SINGULAR|gender=MASCULINE|case=ABLATIVE	
cum	cum	CONJ	_	
fas	fas	IRREG	_	
esse	sum	VB	tense=PR|mood=INFINITIVE|voice=ACTIVE	
putet	puto	VB	person=PERSON_3|number=SINGULAR|tense=PR|mood=SUBJUNCTIVE|voice=ACTIVE	
curam	cura	NN	number=SINGULAR|gender=FEMININE|case=ACCUSATIVE	
sperare	spero	VB	tense=PR|mood=INFINITIVE|voice=ACTIVE	
cohortis	cohors	NN	number=SINGULAR|gender=FEMININE|case=GENITIVE	
qui	qui	PRON	number=SINGULAR|gender=MASCULINE|case=NOMINATIVE	
bona	bonum	NN	number=PLURAL|gender=NEUTER|case=ACCUSATIVE	
donauit	dono	VB	person=PERSON_3|number=SINGULAR|tense=PERF|mood=INDICATIVE|voice=ACTIVE	
praesepibus	praesepis	ADJ	number=PLURAL|gender=MASCULINE|case=DATIVE	
et	et	CONJ	_	
caret	careo	VB	person=PERSON_3|number=SINGULAR|tense=PR|mood=INDICATIVE|voice=ACTIVE	
omni	omnis	ADJ	number=SINGULAR|gender=MASCULINE|case=ABLATIVE	
maiorum	majores	NN	number=PLURAL|gender=MASCULINE|case=GENITIVE	
censu	census	NN	number=SINGULAR|gender=MASCULINE|case=ABLATIVE	
dum	dum	CONJ	_	
peruolat	pervolo	VB	person=PERSON_3|number=SINGULAR|tense=PR|mood=INDICATIVE|voice=ACTIVE	
axe	axis	NN	number=SINGULAR|gender=MASCULINE|case=ABLATIVE	
citato	citatus	ADJ	number=SINGULAR|gender=MASCULINE|case=ABLATIVE	
Flaminiam	flaminius	ADJ	number=SINGULAR|gender=FEMININE|case=ACCUSATIVE	
puer	puer	NN	number=SINGULAR|gender=MASCULINE|case=NOMINATIVE	
Automedon	Automedon	NN	number=SINGULAR|gender=MASCULINE|case=NOMINATIVE	
securus	securus	ADJ	number=SINGULAR|gender=MASCULINE|case=NOMINATIVE	
licet	licet	VB	person=PERSON_3|number=SINGULAR|tense=PR|mood=INDICATIVE|voice=ACTIVE	
Aenean	Aeneas	NN	number=SINGULAR|gender=MASCULINE|case=ACCUSATIVE	
Rutulum	Rutulus	ADJ	number=SINGULAR|gender=MASCULINE|case=ACCUSATIVE|degree=POSITIVE	
-que	que	CONJ	_	
ferocem	ferox	ADJ	number=SINGULAR|gender=MASCULINE|case=ACCUSATIVE	
committas	committo	VB	person=PERSON_2|number=SINGULAR|tense=PR|mood=SUBJUNCTIVE|voice=ACTIVE	
quando	quando	ADV	_	
maior	magnus	ADJ	number=SINGULAR|gender=MASCULINE|case=NOMINATIVE|degree=COMPARATIVE	
avaritiae	avaritia	NN	number=SINGULAR|gender=FEMININE|case=GENITIVE	
patuit	pateo	VB	person=PERSON_3|number=SINGULAR|tense=PERF|mood=INDICATIVE|voice=ACTIVE	
sinus	sinus	NN	number=SINGULAR|gender=MASCULINE|case=NOMINATIVE	
galeatum	galeatus	NN	number=SINGULAR|gender=MASCULINE|case=ACCUSATIVE	
sero	serus	ADJ	number=SINGULAR|gender=NEUTER|case=ABLATIVE	
duelli	duellum	NN	number=SINGULAR|gender=NEUTER|case=GENITIVE	
paenitet	paeniteo	VB	person=PERSON_3|number=SINGULAR|tense=PR|mood=INDICATIVE|voice=ACTIVE	
nota	nosco	VB	number=SINGULAR|tense=PERF|mood=PARTICIPLE|voice=PASSIVE|gender=FEMININE|case=NOMINATIVE	
magis	magis	ADV	_	
nulli	nullus	ADJ	number=SINGULAR|gender=MASCULINE|case=DATIVE	
domus	domus	NN	number=SINGULAR|gender=FEMININE|case=NOMINATIVE	
est	sum	VB	person=PERSON_3|number=SINGULAR|tense=PR|mood=INDICATIVE|voice=ACTIVE	
sua	suus	ADJ	number=SINGULAR|gender=FEMININE|case=NOMINATIVE	
quam	quam	ADV	_	
mihi	ego	PRON	number=SINGULAR|gender=MASCULINE|case=DATIVE	
lucus	lucus	NN	number=SINGULAR|gender=MASCULINE|case=NOMINATIVE	
Martis	Mars	NN	number=SINGULAR|gender=MASCULINE|case=GENITIVE	
et	et	CONJ	_	
Aeoliis	Aeolius	ADJ	number=PLURAL|gender=FEMININE|case=DATIVE	
vicinum	vicinus	ADJ	number=SINGULAR|gender=NEUTER|case=NOMINATIVE	
rupibus	rupes	NN	number=PLURAL|gender=FEMININE|case=DATIVE	
antrum	antrum	NN	number=SINGULAR|gender=NEUTER|case=NOMINATIVE	
Vulcani	Volcanus	NN	number=SINGULAR|gender=MASCULINE|case=GENITIVE	
si	si	CONJ	_	
natura	natura	NN	number=SINGULAR|gender=FEMININE|case=NOMINATIVE	
negat	nego	VB	person=PERSON_3|number=SINGULAR|tense=PR|mood=INDICATIVE|voice=ACTIVE	
facit	facio	VB	person=PERSON_3|number=SINGULAR|tense=PR|mood=INDICATIVE|voice=ACTIVE	
indignatio	indignatio	NN	number=SINGULAR|gender=FEMININE|case=NOMINATIVE	
versum	versus	NN	number=SINGULAR|gender=MASCULINE|case=ACCUSATIVE	
qualemcumque	qualiscumque	PRON	number=SINGULAR|gender=MASCULINE|case=ACCUSATIVE	
potest	possum	VB	person=PERSON_3|number=SINGULAR|tense=PR|mood=INDICATIVE|voice=ACTIVE	
,	comma	CONJ	_	
quales	qualis	ADJ	number=PLURAL|gender=MASCULINE|case=ACCUSATIVE	
ego	ego	PRON	number=SINGULAR|gender=MASCULINE|case=NOMINATIVE	
vel	vel	CONJ	_	
Cluvienus	Cluvienus	NN	number=SINGULAR|gender=MASCULINE|case=NOMINATIVE	
profer	profero	VB	person=PERSON_2|number=SINGULAR|tense=PR|mood=IMPERATIVE|voice=ACTIVE	
Galla	Galla	NN	number=SINGULAR|gender=FEMININE|case=VOCATIVE	
caput	caput	NN	number=SINGULAR|gender=NEUTER|case=ACCUSATIVE	
,	unknown		_	
noli	nolo	VB	person=PERSON_2|number=SINGULAR|tense=PR|mood=IMPERATIVE|voice=ACTIVE	
vexare	vexo	VB	tense=PR|mood=INFINITIVE|voice=ACTIVE	
quiescit	quiesco	VB	person=PERSON_3|number=SINGULAR|tense=PR|mood=INDICATIVE|voice=ACTIVE	
