obtritum	obtero	VB	number=SINGULAR|tense=PERF|mood=PARTICIPLE|voice=PASSIVE|gender=NEUTER|case=NOMINATIVE	
vulgi	vulgus	NN	number=SINGULAR|gender=NEUTER|case=GENITIVE	
perit	pereo	VB	person=PERSON_3|number=SINGULAR|tense=PR|mood=INDICATIVE|voice=ACTIVE	
omne	omnis	ADJ	number=SINGULAR|gender=NEUTER|case=NOMINATIVE	
cadaver	cadaver	NN	number=SINGULAR|gender=NEUTER	
more	mos	NN	number=SINGULAR|gender=MASCULINE|case=ABLATIVE	
animae	anima	NN	number=SINGULAR|gender=FEMININE|case=GENITIVE	
.	unknown		_	
quemvis	quivis	PRON	number=SINGULAR|gender=MASCULINE|case=ACCUSATIVE	
hominem	homo	NN	number=SINGULAR|gender=MASCULINE|case=ACCUSATIVE	
se	sui	PRON	number=SINGULAR|gender=MASCULINE|case=ABLATIVE	
-cum	cum	PREP	_	
attulit	attulo	VB	person=PERSON_3|number=SINGULAR|tense=PR|mood=INDICATIVE|voice=ACTIVE	
ad	ad	PREP	_	
nos	nos	PRON	number=PLURAL|gender=MASCULINE|case=ACCUSATIVE	
ardet	ardeo	VB	person=PERSON_3|number=SINGULAR|tense=PR|mood=INDICATIVE|voice=ACTIVE	
adhuc	adhuc	ADV	_	
,	unknown		_	
et	et	CONJ	_	
iam	jam	ADV	_	
accurrit	accurro	VB	person=PERSON_3|number=SINGULAR|tense=PR|mood=INDICATIVE|voice=ACTIVE	
qui	qui	PRON	number=SINGULAR|gender=MASCULINE|case=NOMINATIVE	
marmora	marmoro	VB	person=PERSON_2|number=SINGULAR|tense=PR|mood=IMPERATIVE|voice=ACTIVE	
donet	dono	VB	person=PERSON_3|number=SINGULAR|tense=PR|mood=SUBJUNCTIVE|voice=ACTIVE	
,			_	
conferat	confero	VB	person=PERSON_3|number=SINGULAR|tense=PR|mood=SUBJUNCTIVE|voice=ACTIVE	
inpensas	impensa	NN	number=PLURAL|gender=FEMININE|case=ACCUSATIVE	
grammaticus	grammaticus	NN	number=SINGULAR|gender=MASCULINE|case=NOMINATIVE	
rhetor	rhetor	NN	number=SINGULAR|gender=MASCULINE|case=NOMINATIVE	
geometres	geometres	NN	number=SINGULAR|gender=MASCULINE|case=NOMINATIVE	
pictor	pictor	NN	number=SINGULAR|gender=MASCULINE|case=NOMINATIVE	
aliptes	aliptes	NN	number=SINGULAR|gender=MASCULINE|case=NOMINATIVE	
augur	augur	NN	number=SINGULAR|gender=MASCULINE|case=NOMINATIVE	
schoenobates	schoenobates	NN	number=SINGULAR|gender=MASCULINE|case=NOMINATIVE	
medicus	medicus	NN	number=SINGULAR|gender=MASCULINE|case=NOMINATIVE	
magus	magus	ADJ	number=SINGULAR|gender=MASCULINE|case=NOMINATIVE	
:	unknown		_	
omnia	omnis	ADJ	number=PLURAL|gender=NEUTER|case=ACCUSATIVE	
novit	nosco	VB	person=PERSON_3|number=SINGULAR|tense=PERF|mood=INDICATIVE|voice=ACTIVE	
Graeculus	Graeculus	NN	number=SINGULAR|gender=MASCULINE|case=NOMINATIVE	
esuriens	exsurio	VB	number=SINGULAR|tense=PR|mood=PARTICIPLE|gender=MASCULINE|case=NOMINATIVE	
Quamvis	quamvis	ADV	_	
digressu	digressus	NN	number=SINGULAR|gender=MASCULINE|case=ABLATIVE	
veteris	vetus	ADJ	number=SINGULAR|gender=MASCULINE|case=GENITIVE	
confusus	confundo	VB	number=SINGULAR|tense=PERF|mood=PARTICIPLE|voice=PASSIVE|gender=MASCULINE|case=NOMINATIVE	
amici	amicus	ADJ	number=SINGULAR|gender=MASCULINE|case=GENITIVE	
laudo	laudo	VB	person=PERSON_1|number=SINGULAR|tense=PR|mood=INDICATIVE|voice=ACTIVE	
tamen	tamen	ADV	_	
vacuis	vacuus	ADJ	number=PLURAL|gender=FEMININE|case=ABLATIVE	
quod	quod	CONJ	_	
sedem	sedes	NN	number=SINGULAR|gender=FEMININE|case=ACCUSATIVE	
figere	figo	VB	tense=PR|mood=INFINITIVE|voice=ACTIVE	
Cumis	Cumae	NN	number=PLURAL|gender=FEMININE|case=ABLATIVE	
destinet	destino	VB	person=PERSON_3|number=SINGULAR|tense=PR|mood=SUBJUNCTIVE|voice=ACTIVE	
atque	atque	CONJ	_	
unum	unus	ADJ	number=SINGULAR|gender=MASCULINE|case=ACCUSATIVE	
civem	civis	NN	number=SINGULAR|gender=MASCULINE|case=ACCUSATIVE	
donare	dono	VB	tense=PR|mood=INFINITIVE|voice=ACTIVE	
Sibyllae	Sibylla	NN	number=SINGULAR|gender=FEMININE|case=DATIVE	
"	unknown		_	
Ebrius	ebrius	ADJ	number=SINGULAR|gender=MASCULINE|case=NOMINATIVE	
ac	atque	CONJ	_	
petulans	petulans	ADJ	number=SINGULAR|gender=MASCULINE|case=NOMINATIVE	
qui	qui	PRON	number=SINGULAR|gender=MASCULINE|case=NOMINATIVE	
nullum	nullus	ADJ	number=SINGULAR|gender=MASCULINE|case=ACCUSATIVE	
forte	fors	NN	number=SINGULAR|gender=FEMININE|case=ABLATIVE	
cecidit	caedo	VB	person=PERSON_3|number=SINGULAR|tense=PERF|mood=INDICATIVE|voice=ACTIVE	
dat	do	VB	person=PERSON_3|number=SINGULAR|tense=PR|mood=INDICATIVE|voice=ACTIVE	
poenas	poena	NN	number=PLURAL|gender=FEMININE|case=ACCUSATIVE	
,			_	
noctem	nox	NN	number=SINGULAR|gender=FEMININE|case=ACCUSATIVE	
patitur	patior	VB	person=PERSON_3|number=SINGULAR|tense=PR|mood=INDICATIVE|voice=PASSIVE	
lugentis	lugeo	VB	number=SINGULAR|tense=PR|mood=PARTICIPLE|gender=MASCULINE|case=GENITIVE	
amicum	amicus	ADJ	number=SINGULAR|gender=MASCULINE|case=ACCUSATIVE	
Pelidae	Pelides	NN	number=SINGULAR|gender=MASCULINE|case=GENITIVE	
cubat	cubo	VB	person=PERSON_3|number=SINGULAR|tense=PR|mood=INDICATIVE|voice=ACTIVE	
in	in	PREP	_	
faciem	facies	NN	number=SINGULAR|gender=FEMININE|case=ACCUSATIVE	
mox	mox	ADV	_	
deinde	deinde	ADV	_	
supinus	supinus	ADJ	number=SINGULAR|gender=MASCULINE|case=NOMINATIVE	
ianua	janua	NN	number=SINGULAR|gender=FEMININE|case=NOMINATIVE	
Baiarum	Baiae	NN	number=PLURAL|gender=FEMININE|case=GENITIVE	
est	sum	VB	person=PERSON_3|number=SINGULAR|tense=PR|mood=INDICATIVE|voice=ACTIVE	
et	et	CONJ	_	
gratum	gratus	ADJ	number=SINGULAR|gender=NEUTER|case=NOMINATIVE	
litus	litus	NN	number=SINGULAR|gender=NEUTER|case=NOMINATIVE	
amoeni	amoenus	ADJ	number=SINGULAR|gender=MASCULINE|case=GENITIVE	
secessus	secessus	NN	number=SINGULAR|gender=MASCULINE|case=GENITIVE	
ego	ego	PRON	number=SINGULAR|gender=MASCULINE|case=NOMINATIVE	
vel	vel	CONJ	_	
Prochytam	Prochyta	NN	number=SINGULAR|gender=FEMININE|case=ACCUSATIVE	
praepono	praepono	VB	person=PERSON_1|number=SINGULAR|tense=PR|mood=INDICATIVE|voice=ACTIVE	
Suburae	Subura	NN	number=SINGULAR|gender=FEMININE|case=DATIVE	
nam	nam	ADV	_	
quid	quis	PRON	number=SINGULAR|gender=NEUTER|case=ACCUSATIVE	
agas	ago	VB	person=PERSON_2|number=SINGULAR|tense=PR|mood=SUBJUNCTIVE|voice=ACTIVE	
cum	Cum	CONJ	_	
te	tu	PRON	number=SINGULAR|gender=MASCULINE|case=ACCUSATIVE	
furiosus	furiosus	ADJ	number=SINGULAR|gender=MASCULINE|case=NOMINATIVE	
cogat	cogo	VB	person=PERSON_3|number=SINGULAR|tense=PR|mood=SUBJUNCTIVE|voice=ACTIVE	
et	et	CONJ	_	
idem	idem	PRON	number=SINGULAR|gender=MASCULINE|case=NOMINATIVE	
fortior	fortis	ADJ	number=SINGULAR|gender=MASCULINE|case=NOMINATIVE|degree=COMPARATIVE	
quamvis	quamvis	ADV	_	
quota	quotus	ADJ	number=SINGULAR|gender=FEMININE|case=NOMINATIVE	
portio	portio	NN	number=SINGULAR|gender=FEMININE|case=NOMINATIVE	
faecis	faex	NN	number=SINGULAR|gender=FEMININE|case=GENITIVE	
Achaei	Achaeus	ADJ	number=PLURAL|gender=MASCULINE|case=NOMINATIVE	
quantum	quantus	ADJ	number=SINGULAR|gender=NEUTER|case=ACCUSATIVE	
quisque	quisque	PRON	number=SINGULAR|gender=MASCULINE|case=NOMINATIVE	
sua	suus	ADJ	number=SINGULAR|gender=FEMININE|case=ABLATIVE	
nummorum	nummus	NN	number=PLURAL|gender=MASCULINE|case=GENITIVE	
servat	servo	VB	person=PERSON_3|number=SINGULAR|tense=PR|mood=INDICATIVE|voice=ACTIVE	
in	in	PREP	_	
arca	arca	NN	number=SINGULAR|gender=FEMININE|case=ABLATIVE	
,			_	
tantum	tantus	ADJ	number=SINGULAR|gender=NEUTER|case=ACCUSATIVE	
habet	habeo	VB	person=PERSON_3|number=SINGULAR|tense=PR|mood=INDICATIVE|voice=ACTIVE	
et	et	CONJ	_	
fidei	fides	NN	number=SINGULAR|gender=FEMININE|case=GENITIVE	
,	comma		_	
iures	juro	VB	person=PERSON_2|number=SINGULAR|tense=PR|mood=SUBJUNCTIVE|voice=ACTIVE	
licet	licet	VB	person=PERSON_3|number=SINGULAR|tense=PR|mood=INDICATIVE|voice=ACTIVE	
et	et	CONJ	_	
Samothracum	Samothraces	NN	number=PLURAL|gender=MASCULINE|case=GENITIVE	
et	et	CONJ	_	
nostrorum	noster	ADJ	number=PLURAL|gender=MASCULINE|case=GENITIVE	
aras	ara	NN	number=PLURAL|gender=FEMININE|case=ACCUSATIVE	
,			_	
contemnere	contemno	VB	tense=PR|mood=INFINITIVE|voice=ACTIVE	
fulmina	fulmen	NN	number=PLURAL|gender=NEUTER|case=ACCUSATIVE	
pauper	pauper	NN	number=SINGULAR|gender=MASCULINE	
creditur	credo	VB	person=PERSON_3|number=SINGULAR|tense=PR|mood=INDICATIVE|voice=PASSIVE	
atque	atque	CONJ	_	
deos	deus	NN	number=PLURAL|gender=MASCULINE|case=ACCUSATIVE	
dis	deus	ADJ	number=PLURAL|gender=MASCULINE|case=ABLATIVE	
ignoscentibus	ignosco	VB	number=PLURAL|tense=PR|mood=PARTICIPLE|gender=MASCULINE|case=ABLATIVE	
ipsis	ipse	PRON	number=PLURAL|gender=MASCULINE|case=ABLATIVE	
ranarum	rana	NN	number=PLURAL|gender=FEMININE|case=GENITIVE	
viscera	viscera	NN	number=PLURAL|gender=NEUTER|case=ACCUSATIVE	
numquam	numquam	ADV	_	
inspexi	inspicio	VB	person=PERSON_1|number=SINGULAR|tense=PERF|mood=INDICATIVE|voice=ACTIVE	
est	sum	VB	person=PERSON_3|number=SINGULAR|tense=PR|mood=INDICATIVE|voice=ACTIVE	
aliquid	aliquis	PRON	number=SINGULAR|gender=NEUTER|case=NOMINATIVE	
quocumque	quicumque	PRON	number=SINGULAR|gender=MASCULINE|case=ABLATIVE	
loco	locus	NN	number=SINGULAR|gender=MASCULINE|case=ABLATIVE	
,			_	
quocumque	quicumque	PRON	number=SINGULAR|gender=MASCULINE|case=ABLATIVE	
recessu	recessus	NN	number=SINGULAR|gender=MASCULINE|case=ABLATIVE	
unius	unus	ADJ	number=SINGULAR|gender=FEMININE|case=GENITIVE	
sese	sui	PRON	number=SINGULAR|gender=MASCULINE|case=ACCUSATIVE	
dominum	dominus	NN	number=SINGULAR|gender=MASCULINE|case=ACCUSATIVE	
fecisse	facio	VB	tense=PERF|mood=INFINITIVE|voice=ACTIVE	
lacertae	lacerta	NN	number=SINGULAR|gender=FEMININE|case=GENITIVE	
me	ego	PRON	number=SINGULAR|gender=MASCULINE|case=ABLATIVE	
nemo	nemo	NN	number=SINGULAR|gender=MASCULINE|case=NOMINATIVE	
ministro	minister	ADJ	number=SINGULAR|gender=MASCULINE|case=ABLATIVE	
fur	fur	NN	number=SINGULAR|gender=MASCULINE|case=NOMINATIVE	
erit	sum	VB	person=PERSON_3|number=SINGULAR|tense=FUTURE|mood=INDICATIVE|voice=ACTIVE	
atque	atque	CONJ	_	
ideo	ideo	ADV	_	
nulli	nullus	ADJ	number=SINGULAR|gender=MASCULINE|case=DATIVE	
comes	comes	NN	number=SINGULAR|gender=MASCULINE|case=NOMINATIVE	
exeo	exeo	VB	person=PERSON_1|number=SINGULAR|tense=PR|mood=INDICATIVE|voice=ACTIVE	
tamquam	tamquam	ADV	_	
mancus	mancus	ADJ	number=SINGULAR|gender=MASCULINE|case=NOMINATIVE	
et	et	CONJ	_	
extinctae	extingo	VB	number=SINGULAR|tense=PERF|mood=PARTICIPLE|voice=PASSIVE|gender=FEMININE|case=GENITIVE	
corpus	corpus	NN	number=SINGULAR|gender=NEUTER|case=NOMINATIVE	
non	non	ADV	_	
utile	utilis	ADJ	number=SINGULAR|gender=NEUTER|case=NOMINATIVE	
dextrae	dextera	NN	number=SINGULAR|gender=FEMININE|case=GENITIVE	
.	period		_	
alter	alter	ADJ	number=SINGULAR|gender=MASCULINE|case=NOMINATIVE	
enim	enim	ADV	_	
quantum	quantus	ADJ	number=SINGULAR|gender=NEUTER|case=ACCUSATIVE	
in	in	PREP	_	
legione	legio	NN	number=SINGULAR|gender=FEMININE|case=ABLATIVE	
tribuni	tribunus	NN	number=PLURAL|gender=MASCULINE|case=NOMINATIVE	
accipiunt	accipio	VB	person=PERSON_3|number=PLURAL|tense=PR|mood=INDICATIVE|voice=ACTIVE	
donat	dono	VB	person=PERSON_3|number=SINGULAR|tense=PR|mood=INDICATIVE|voice=ACTIVE	
Calvinae	Calvina	NN	number=SINGULAR|gender=FEMININE|case=DATIVE	
vel	vel	CONJ	_	
Catienae	Catiena	NN	number=SINGULAR|gender=FEMININE|case=DATIVE	
ut	ut	CONJ	_	
semel	semel	ADV	_	
aut	aut	CONJ	_	
iterum	iterum	ADV	_	
super	super	PREP	_	
illam	ille	PRON	number=SINGULAR|gender=FEMININE|case=ACCUSATIVE	
palpitet	palpito	VB	person=PERSON_3|number=SINGULAR|tense=PR|mood=SUBJUNCTIVE|voice=ACTIVE	
quot	quot	ADV	_	
possidet	possideo	VB	person=PERSON_3|number=SINGULAR|tense=PR|mood=INDICATIVE|voice=ACTIVE	
agri	ager	NN	number=SINGULAR|gender=MASCULINE|case=GENITIVE	
iugera	jugerum	NN	number=PLURAL|gender=NEUTER|case=ACCUSATIVE	
Corbulo	Corbulo	NN	number=SINGULAR|gender=MASCULINE|case=NOMINATIVE	
vix	vix	ADV	_	
ferret	fero	VB	person=PERSON_3|number=SINGULAR|tense=IMP|voice=ACTIVE	
tot	tot	ADV	_	
vasa	vasum	NN	number=PLURAL|gender=NEUTER|case=ACCUSATIVE	
ingentia	ingens	ADJ	number=PLURAL|gender=NEUTER|case=ACCUSATIVE	
,			_	
tot	tot	ADV	_	
res	res	NN	number=PLURAL|gender=FEMININE|case=ACCUSATIVE	
inpositas	inpono	VB	number=PLURAL|tense=PERF|mood=PARTICIPLE|voice=PASSIVE|gender=FEMININE|case=ACCUSATIVE	
capiti	caput	NN	number=SINGULAR|gender=NEUTER|case=DATIVE	
quas	qui	ADJ	number=PLURAL|gender=FEMININE|case=ACCUSATIVE	
recto	rectus	ADJ	number=SINGULAR|gender=MASCULINE|case=ABLATIVE	
vertice	vertex	NN	number=SINGULAR|gender=MASCULINE|case=ABLATIVE	
portat	porto	VB	person=PERSON_3|number=SINGULAR|tense=PR|mood=INDICATIVE|voice=ACTIVE	
servulus	servulus	NN	number=SINGULAR|gender=MASCULINE|case=NOMINATIVE	
infelix	infelix	ADJ	number=SINGULAR|gender=MASCULINE|case=NOMINATIVE	
et	et	CONJ	_	
cursu	cursus	NN	number=SINGULAR|gender=MASCULINE|case=ABLATIVE	
ventilat	ventilo	VB	person=PERSON_3|number=SINGULAR|tense=PR|mood=INDICATIVE|voice=ACTIVE	
ignem	ignis	NN	number=SINGULAR|gender=MASCULINE|case=ACCUSATIVE	
.	unknown		_	
"	unknown		_	
Horum	hic	PRON	number=PLURAL|gender=MASCULINE|case=GENITIVE	
ego	ego	PRON	number=SINGULAR|gender=MASCULINE|case=NOMINATIVE	
non	non	ADV	_	
fugiam	fugio	VB	person=PERSON_1|number=SINGULAR|tense=PR|mood=SUBJUNCTIVE|voice=ACTIVE	
conchylia	conchylium	NN	number=PLURAL|gender=NEUTER|case=ACCUSATIVE	
ergo	ergo	ADV	_	
optes	opto	VB	person=PERSON_2|number=SINGULAR|tense=PR|mood=SUBJUNCTIVE|voice=ACTIVE	
votum	votum	NN	number=SINGULAR|gender=NEUTER|case=ACCUSATIVE	
-que	que	CONJ	_	
feras	fero	VB	person=PERSON_2|number=SINGULAR|tense=PR|mood=SUBJUNCTIVE|voice=ACTIVE	
miserabile	miserabilis	ADJ	number=SINGULAR|gender=NEUTER|case=ACCUSATIVE	
te	tu	PRON	number=SINGULAR|gender=MASCULINE|case=ABLATIVE	
-cum	cum	PREP	_	
ut	ut	CONJ	_	
sint	sum	VB	person=PERSON_3|number=PLURAL|tense=PR|mood=SUBJUNCTIVE|voice=ACTIVE	
contentae	contineo	VB	number=PLURAL|tense=PERF|mood=PARTICIPLE|voice=PASSIVE|gender=FEMININE|case=NOMINATIVE	
patulas	patulus	ADJ	number=PLURAL|gender=FEMININE|case=ACCUSATIVE	
defundere	defundo	VB	tense=PR|mood=INFINITIVE|voice=ACTIVE	
pelves	pelvis	NN	number=PLURAL|gender=FEMININE|case=ACCUSATIVE	
quando	quando	ADV	_	
in	in	PREP	_	
consilio	consilium	NN	number=SINGULAR|gender=NEUTER|case=ABLATIVE	
est	sum	VB	person=PERSON_3|number=SINGULAR|tense=PR|mood=INDICATIVE|voice=ACTIVE	
aedilibus	aedilis	NN	number=PLURAL|gender=MASCULINE|case=DATIVE	
armato	armatus	NN	number=SINGULAR|gender=MASCULINE|case=ABLATIVE	
quotiens	quotiens	ADV	_	
tutae	tueor	VB	number=PLURAL|tense=PERF|mood=PARTICIPLE|voice=PASSIVE|gender=FEMININE|case=NOMINATIVE	
custode	custos	NN	number=SINGULAR|gender=MASCULINE|case=ABLATIVE	
tenentur	teneo	VB	person=PERSON_3|number=PLURAL|tense=PR|mood=INDICATIVE|voice=PASSIVE	
et	et	CONJ	_	
Pomptina	Pomptinus	ADJ	number=SINGULAR|gender=FEMININE|case=NOMINATIVE	
palus	palus	NN	number=SINGULAR|gender=FEMININE|case=NOMINATIVE	
et	et	CONJ	_	
Gallinaria	gallinarius	ADJ	number=SINGULAR|gender=FEMININE|case=NOMINATIVE	
pinus	pinus	NN	number=SINGULAR|gender=FEMININE|case=NOMINATIVE	
sic	sic	ADV	_	
inde	inde	ADV	_	
huc	huc	ADV	_	
omnes	omnis	ADJ	number=PLURAL|gender=MASCULINE|case=NOMINATIVE	
tamquam	tamquam	ADV	_	
ad	ad	PREP	_	
vivaria	vivarium	NN	number=PLURAL|gender=NEUTER|case=ACCUSATIVE	
currunt	curro	VB	person=PERSON_3|number=PLURAL|tense=PR|mood=INDICATIVE|voice=ACTIVE	
nobis	nos	PRON	number=PLURAL|gender=MASCULINE|case=DATIVE	
properantibus	propero	VB	number=PLURAL|tense=PR|mood=PARTICIPLE|gender=MASCULINE|case=DATIVE	
opstat	obsto	VB	person=PERSON_3|number=SINGULAR|tense=PR|voice=ACTIVE	
unda	unda	NN	number=SINGULAR|gender=FEMININE|case=NOMINATIVE	
prior	prior	ADJ	number=SINGULAR|gender=FEMININE|case=NOMINATIVE|degree=COMPARATIVE	
,			_	
magno	magnus	ADJ	number=SINGULAR|gender=NEUTER|case=ABLATIVE	
populus	populus	NN	number=SINGULAR|gender=MASCULINE|case=NOMINATIVE	
premit	premo	VB	person=PERSON_3|number=SINGULAR|tense=PR|mood=INDICATIVE|voice=ACTIVE	
agmine	agmen	NN	number=SINGULAR|gender=NEUTER|case=ABLATIVE	
lumbos	lumbus	NN	number=PLURAL|gender=MASCULINE|case=ACCUSATIVE	
qui	qui	PRON	number=SINGULAR|gender=MASCULINE|case=NOMINATIVE	
sequitur	sequor	VB	person=PERSON_3|number=SINGULAR|tense=PR|mood=INDICATIVE|voice=PASSIVE	
quid	quis	NN	number=SINGULAR|gender=NEUTER|case=ACCUSATIVE	
te	tu	PRON	number=SINGULAR|gender=MASCULINE|case=ACCUSATIVE	
moror	moror	VB	person=PERSON_1|number=SINGULAR|tense=PR|mood=INDICATIVE|voice=PASSIVE	
librum	liber	NN	number=SINGULAR|gender=MASCULINE|case=ACCUSATIVE	
si	si	CONJ	_	
malus	malus	ADJ	number=SINGULAR|gender=MASCULINE|case=NOMINATIVE	
est	sum	VB	person=PERSON_3|number=SINGULAR|tense=PR|mood=INDICATIVE|voice=ACTIVE	
nequeo	nequeo	VB	person=PERSON_1|number=SINGULAR|tense=PR|mood=INDICATIVE|voice=ACTIVE	
laudare	laudo	VB	tense=PR|mood=INFINITIVE|voice=ACTIVE	
et	et	CONJ	_	
poscere	posco	VB	tense=PR|mood=INFINITIVE|voice=ACTIVE	
haec	hic	ADJ	number=PLURAL|gender=NEUTER|case=ACCUSATIVE	
eadem	idem	PRON	number=PLURAL|gender=NEUTER|case=ACCUSATIVE	
licet	licet	VB	person=PERSON_3|number=SINGULAR|tense=PR|mood=INDICATIVE|voice=ACTIVE	
et	et	CONJ	_	
nobis	nos	PRON	number=PLURAL|gender=MASCULINE|case=DATIVE	
laudare	laudo	VB	tense=PR|mood=INFINITIVE|voice=ACTIVE	
sed	sed	CONJ	_	
illis	ille	PRON	number=PLURAL|gender=MASCULINE|case=DATIVE	
creditur	credo	VB	person=PERSON_3|number=SINGULAR|tense=PR|mood=INDICATIVE|voice=PASSIVE	
.	unknown		_	
omnis	omnis	ADJ	number=SINGULAR|gender=FEMININE|case=NOMINATIVE	
enim	enim	CONJ	_	
populo	populus	NN	number=SINGULAR|gender=MASCULINE|case=DATIVE	
mercedem	merces	NN	number=SINGULAR|gender=FEMININE|case=ACCUSATIVE	
pendere	pendo	VB	tense=PR|mood=INFINITIVE|voice=ACTIVE	
iussa	jubeo	VB	number=SINGULAR|tense=PERF|mood=PARTICIPLE|voice=PASSIVE|gender=FEMININE|case=NOMINATIVE	
est	sum	VB	person=PERSON_3|number=SINGULAR|tense=PR|mood=INDICATIVE|voice=ACTIVE	
arbor	arbor	NN	number=SINGULAR|gender=FEMININE|case=NOMINATIVE	
et	et	CONJ	_	
eiectis	eicio	VB	number=PLURAL|tense=PERF|mood=PARTICIPLE|voice=PASSIVE|gender=FEMININE|case=ABLATIVE	
mendicat	mendico	VB	person=PERSON_3|number=SINGULAR|tense=PR|mood=INDICATIVE|voice=ACTIVE	
silva	silva	NN	number=SINGULAR|gender=FEMININE|case=NOMINATIVE	
Camenis	Camena	NN	number=PLURAL|gender=FEMININE|case=ABLATIVE	
"	unknown		_	
His	hic	PRON	number=PLURAL|gender=FEMININE|case=DATIVE	
alias	Alius	ADJ	number=PLURAL|gender=FEMININE|case=ACCUSATIVE	
poteram	possum	VB	person=PERSON_1|number=SINGULAR|tense=IMP|mood=INDICATIVE|voice=ACTIVE	
et	et	ADV	_	
pluris	multus	ADJ	number=PLURAL|gender=FEMININE|case=ACCUSATIVE	
subnectere	subnecto	VB	tense=PR|mood=INFINITIVE|voice=ACTIVE	
causas	causa	NN	number=PLURAL|gender=FEMININE|case=ACCUSATIVE	
sed	sed	CONJ	_	
iumenta	jumentum	NN	number=PLURAL|gender=NEUTER|case=NOMINATIVE	
vocant	voco	VB	person=PERSON_3|number=PLURAL|tense=PR|mood=INDICATIVE|voice=ACTIVE	
et	et	CONJ	_	
sol	sol	NN	number=SINGULAR|gender=MASCULINE|case=NOMINATIVE	
inclinat	inclino	VB	person=PERSON_3|number=SINGULAR|tense=PR|mood=INDICATIVE|voice=ACTIVE	
.	unknown		_	
rides	rideo	VB	person=PERSON_2|number=SINGULAR|tense=PR|mood=INDICATIVE|voice=ACTIVE	
maiore	magnus	ADJ	number=SINGULAR|gender=MASCULINE|case=ABLATIVE|degree=COMPARATIVE	
cachinno	cachinnus	NN	number=SINGULAR|gender=MASCULINE|case=ABLATIVE	
concutitur	concutio	VB	person=PERSON_3|number=SINGULAR|tense=PR|mood=INDICATIVE|voice=PASSIVE	
raedarum	raeda	NN	number=PLURAL|gender=FEMININE|case=GENITIVE	
transitus	transitus	NN	number=SINGULAR|gender=MASCULINE|case=NOMINATIVE	
arto	artus	ADJ	number=SINGULAR|gender=MASCULINE|case=ABLATIVE	
vicorum	vicus	NN	number=PLURAL|gender=MASCULINE|case=GENITIVE	
in	in	PREP	_	
flexu	flexus	NN	number=SINGULAR|gender=MASCULINE|case=ABLATIVE	
et	et	CONJ	_	
stantis	sto	VB	number=SINGULAR|tense=PR|mood=PARTICIPLE|gender=FEMININE|case=GENITIVE	
convicia	convicium	NN	number=PLURAL|gender=NEUTER|case=NOMINATIVE	
mandrae	mandra	NN	number=SINGULAR|gender=FEMININE|case=GENITIVE	
eripient	eripio	VB	person=PERSON_3|number=PLURAL|tense=FUTURE|mood=INDICATIVE|voice=ACTIVE	
somnum	somnus	NN	number=SINGULAR|gender=MASCULINE|case=ACCUSATIVE	
Druso	Drusus	NN	number=SINGULAR|gender=MASCULINE|case=ABLATIVE	
vitulis	vitulus	NN	number=PLURAL|gender=MASCULINE|case=ABLATIVE	
-que	que	CONJ	_	
marinis	marinus	ADJ	number=PLURAL|gender=MASCULINE|case=ABLATIVE	
iam	jam	ADV	_	
poscit	posco	VB	person=PERSON_3|number=SINGULAR|tense=PR|mood=INDICATIVE|voice=ACTIVE	
aquam	aqua	NN	number=SINGULAR|gender=FEMININE|case=ACCUSATIVE	
,	comma	CONJ	_	
iam	jam	ADV	_	
frivola	frivolus	ADJ	number=PLURAL|gender=NEUTER|case=ACCUSATIVE	
transfert	transfero	VB	person=PERSON_3|number=SINGULAR|tense=PR|mood=INDICATIVE|voice=ACTIVE	
Vcalegon	Vcalegon	NN	number=SINGULAR|gender=MASCULINE|case=NOMINATIVE	
,	comma	CONJ	_	
tabulata	tabulatum	NN	number=PLURAL|gender=NEUTER|case=NOMINATIVE	
tibi	tu	PRON	number=SINGULAR|gender=MASCULINE|case=DATIVE	
iam	jam	ADV	_	
tertia	tertius	ADJ	number=PLURAL|gender=NEUTER|case=NOMINATIVE	
fumant	fumo	VB	person=PERSON_3|number=PLURAL|tense=PR|mood=INDICATIVE|voice=ACTIVE	
tu	tu	PRON	number=SINGULAR|gender=MASCULINE|case=NOMINATIVE	
nescis	nescio	VB	person=PERSON_2|number=SINGULAR|tense=PR|mood=INDICATIVE|voice=ACTIVE	
hic	hic	ADV	_	
ultra	ultra	PREP	_	
vires	vis	NN	number=PLURAL|gender=FEMININE|case=ACCUSATIVE	
habitus	habitus	NN	number=SINGULAR|gender=MASCULINE|case=GENITIVE	
nitor	nitor	NN	number=SINGULAR|gender=MASCULINE|case=NOMINATIVE	
,			_	
hic	hic	ADV	_	
aliquid	aliquis	PRON	number=SINGULAR|gender=NEUTER|case=NOMINATIVE	
plus	multus	ADJ	number=SINGULAR|case=NOMINATIVE|degree=COMPARATIVE	
quam	quam	CONJ	_	
satis	satis	ADJ	number=SINGULAR|gender=NEUTER|case=NOMINATIVE	
est	sum	VB	person=PERSON_3|number=SINGULAR|tense=PR|mood=INDICATIVE|voice=ACTIVE	
interdum	interdum	ADV	_	
aliena	alienus	ADJ	number=SINGULAR|gender=FEMININE|case=ABLATIVE	
sumitur	sumo	VB	person=PERSON_3|number=SINGULAR|tense=PR|mood=INDICATIVE|voice=PASSIVE	
arca	arca	NN	number=SINGULAR|gender=FEMININE|case=ABLATIVE	
vivant	vivo	VB	person=PERSON_3|number=PLURAL|tense=PR|mood=SUBJUNCTIVE|voice=ACTIVE	
Artorius	Artorius	NN	number=SINGULAR|gender=MASCULINE|case=NOMINATIVE	
istic	istic	ADV	_	
et	et	CONJ	_	
Catulus	Catulus	NN	number=SINGULAR|gender=MASCULINE|case=NOMINATIVE	
maneant	maneo	VB	person=PERSON_3|number=PLURAL|tense=PR|mood=SUBJUNCTIVE|voice=ACTIVE	
qui	qui	NN	number=PLURAL|gender=MASCULINE|case=NOMINATIVE	
nigrum	niger	ADJ	number=SINGULAR|gender=NEUTER|case=ACCUSATIVE	
in	in	PREP	_	
candida	candidus	ADJ	number=PLURAL|gender=NEUTER|case=ACCUSATIVE	
vertunt	verto	VB	person=PERSON_3|number=PLURAL|tense=PR|mood=INDICATIVE|voice=ACTIVE	
quis	qui	PRON	number=PLURAL|gender=MASCULINE|case=DATIVE	
facile	facilis	ADJ	number=SINGULAR|gender=NEUTER|case=NOMINATIVE	
est	sum	VB	person=PERSON_3|number=SINGULAR|tense=PR|mood=INDICATIVE|voice=ACTIVE	
aedem	aedes	NN	number=SINGULAR|gender=FEMININE|case=ACCUSATIVE	
conducere	conduco	VB	tense=PR|mood=INFINITIVE|voice=ACTIVE	
flumina	flumen	NN	number=PLURAL|gender=NEUTER|case=ACCUSATIVE	
portus	portus	NN	number=PLURAL|gender=MASCULINE|case=ACCUSATIVE	
,	comma	CONJ	_	
siccandam	sicco	VB	number=SINGULAR|mood=GERUNDIVE|gender=FEMININE|case=ACCUSATIVE	
eluviem	eluvies	NN	number=SINGULAR|gender=FEMININE|case=ACCUSATIVE	
portandum	porto	VB	number=SINGULAR|mood=GERUNDIVE|gender=NEUTER|case=ACCUSATIVE	
ad	ad	PREP	_	
busta	bustum	NN	number=PLURAL|gender=NEUTER|case=ACCUSATIVE	
cadaver	cadaver	NN	number=SINGULAR|gender=NEUTER|case=ACCUSATIVE	
et	et	CONJ	_	
praebere	praebeo	VB	tense=PR|mood=INFINITIVE|voice=ACTIVE	
caput	caput	NN	number=SINGULAR|gender=NEUTER|case=ACCUSATIVE	
domina	domina	NN	number=SINGULAR|gender=FEMININE|case=ABLATIVE	
venale	venalis	ADJ	number=SINGULAR|gender=NEUTER|case=ACCUSATIVE	
sub	sub	PREP	_	
hasta	hasta	NN	number=SINGULAR|gender=FEMININE|case=ABLATIVE	
quondam	quondam	ADV	_	
hi	hic	PRON	number=PLURAL|gender=MASCULINE|case=NOMINATIVE	
cornicines	cornicen	NN	number=PLURAL|gender=MASCULINE|case=NOMINATIVE	
et	et	CONJ	_	
municipalis	municipalis	ADJ	number=SINGULAR|gender=FEMININE|case=GENITIVE	
harenae	harena	NN	number=SINGULAR|gender=FEMININE|case=GENITIVE	
perpetui	perpetuus	ADJ	number=PLURAL|gender=MASCULINE|case=NOMINATIVE	
comites	comes	NN	number=PLURAL|gender=MASCULINE|case=NOMINATIVE	
notae	nosco	VB	number=PLURAL|tense=PERF|mood=PARTICIPLE|voice=PASSIVE|gender=FEMININE|case=NOMINATIVE	
-que	que	CONJ	_	
per	per	PREP	_	
oppida	oppidum	NN	number=PLURAL|gender=NEUTER|case=ACCUSATIVE	
buccae	bucca	NN	number=PLURAL|gender=FEMININE|case=NOMINATIVE	
munera	munus	NN	number=PLURAL|gender=NEUTER|case=ACCUSATIVE	
nunc	nunc	ADV	_	
edunt	edo	VB	person=PERSON_3|number=PLURAL|tense=PR|mood=INDICATIVE|voice=ACTIVE	
et	et	CONJ	_	
verso	verto	VB	number=SINGULAR|tense=PERF|mood=PARTICIPLE|voice=PASSIVE|gender=MASCULINE|case=ABLATIVE	
pollice	pollex	NN	number=SINGULAR|gender=MASCULINE|case=ABLATIVE	
vulgus	vulgus	ADJ	number=SINGULAR|gender=NEUTER|case=NOMINATIVE	
cum	Cum	CONJ	_	
iubet	jubeo	VB	person=PERSON_3|number=SINGULAR|tense=PR|mood=INDICATIVE|voice=ACTIVE	
occidunt	occido	VB	person=PERSON_3|number=PLURAL|tense=PR|mood=INDICATIVE|voice=ACTIVE	
populariter	populariter	ADV	_	
ne	ne	ADV	_	
-c	que	CONJ	_	
tamen	tamen	ADV	_	
Antiochus	Antiochus	NN	number=SINGULAR|gender=MASCULINE|case=NOMINATIVE	
ne	ne	ADV	_	
-c	que	CONJ	_	
erit	sum	VB	person=PERSON_3|number=SINGULAR|tense=FUTURE|mood=INDICATIVE|voice=ACTIVE	
mirabilis	mirabilis	ADJ	number=SINGULAR|gender=MASCULINE|case=NOMINATIVE	
illic	illic	ADV	_	
aut	aut	CONJ	_	
Stratocles	Stratocles	NN	number=SINGULAR|gender=MASCULINE|case=NOMINATIVE	
aut	aut	CONJ	_	
cum	cum	PREP	_	
molli	mollis	ADJ	number=SINGULAR|gender=MASCULINE|case=ABLATIVE	
Demetrius	Demetrius	NN	number=SINGULAR|gender=MASCULINE|case=NOMINATIVE	
Haemo	Haemus	NN	number=SINGULAR|gender=MASCULINE|case=ABLATIVE	
rusticus	rusticus	ADJ	number=SINGULAR|gender=MASCULINE|case=NOMINATIVE	
ille	ille	PRON	number=SINGULAR|gender=MASCULINE|case=NOMINATIVE	
tuus	tuus	ADJ	number=SINGULAR|gender=MASCULINE|case=NOMINATIVE	
sumit	sumo	VB	person=PERSON_3|number=SINGULAR|tense=PR|mood=INDICATIVE|voice=ACTIVE	
trechedipna	trechedipnum	NN	number=PLURAL|gender=NEUTER|case=ACCUSATIVE	
Quirine	Quirinus	NN	number=SINGULAR|gender=MASCULINE|case=VOCATIVE	
et	et	CONJ	_	
ceromatico	ceromaticus	ADJ	number=SINGULAR|gender=NEUTER|case=ABLATIVE	
fert	fero	VB	person=PERSON_3|number=SINGULAR|tense=PR|mood=INDICATIVE|voice=ACTIVE	
niceteria	niceterium	NN	number=PLURAL|gender=NEUTER|case=ACCUSATIVE	
collo	collum	NN	number=SINGULAR|gender=NEUTER|case=ABLATIVE	
nam	nam	ADV	_	
quid	quis	PRON	number=SINGULAR|gender=NEUTER|case=ACCUSATIVE	
tam	tam	ADV	_	
miserum	miser	ADJ	number=SINGULAR|gender=NEUTER|case=ACCUSATIVE	
,	comma	CONJ	_	
tam	tam	ADV	_	
solum	solus	ADJ	number=SINGULAR|gender=NEUTER|case=ACCUSATIVE	
vidimus	video	VB	person=PERSON_1|number=PLURAL|tense=PERF|mood=INDICATIVE|voice=ACTIVE	
ut	ut	CONJ	_	
non	non	ADV	_	
deterius	deterior	ADJ	number=SINGULAR|gender=NEUTER|case=ACCUSATIVE|degree=COMPARATIVE	
credas	credo	VB	person=PERSON_2|number=SINGULAR|tense=PR|mood=SUBJUNCTIVE|voice=ACTIVE	
horrere	horreo	VB	tense=PR|mood=INFINITIVE|voice=ACTIVE	
incendia	incendium	NN	number=PLURAL|gender=NEUTER|case=ACCUSATIVE	
lapsus	lapsus	NN	number=PLURAL|gender=MASCULINE|case=ACCUSATIVE	
tectorum	tectum	NN	number=PLURAL|gender=NEUTER|case=GENITIVE	
adsiduos	assiduus	NN	number=PLURAL|gender=MASCULINE|case=ACCUSATIVE	
ac	atque	CONJ	_	
mille	mille	NRL	_	
pericula	periculum	NN	number=PLURAL|gender=NEUTER|case=ACCUSATIVE	
saevae	saevus	ADJ	number=SINGULAR|gender=FEMININE|case=GENITIVE	
urbis	urbs	NN	number=SINGULAR|gender=FEMININE|case=GENITIVE	
et	et	CONJ	_	
Augusto	Augustus	NN	number=SINGULAR|gender=MASCULINE|case=ABLATIVE	
recitantes	recito	VB	number=PLURAL|tense=PR|mood=PARTICIPLE|gender=MASCULINE|case=ACCUSATIVE	
mense	mensis	NN	number=SINGULAR|gender=MASCULINE|case=ABLATIVE	
poetas	poeta	NN	number=PLURAL|gender=MASCULINE|case=ACCUSATIVE	
"	unknown		_	
Respice	respicio	VB	person=PERSON_2|number=SINGULAR|tense=PR|mood=IMPERATIVE|voice=ACTIVE	
nunc	nunc	ADV	_	
alia	Alius	ADJ	number=PLURAL|gender=NEUTER|case=ACCUSATIVE	
ac	atque	CONJ	_	
diversa	divorto	VB	number=PLURAL|tense=PERF|mood=PARTICIPLE|voice=PASSIVE|gender=NEUTER|case=ACCUSATIVE	
pericula	periculum	NN	number=PLURAL|gender=NEUTER|case=ACCUSATIVE	
noctis	nox	NN	number=SINGULAR|gender=FEMININE|case=GENITIVE	
quod	qui	PRON	number=SINGULAR|gender=NEUTER|case=ACCUSATIVE	
spatium	spatium	NN	number=SINGULAR|gender=NEUTER|case=ACCUSATIVE	
tectis	tectum	NN	number=PLURAL|gender=NEUTER|case=ABLATIVE	
sublimibus	sublime	NN	number=PLURAL|gender=NEUTER|case=ABLATIVE	
unde	unde	ADV	_	
cerebrum	cerebrum	NN	number=SINGULAR|gender=NEUTER|case=ACCUSATIVE	
testa	testa	NN	number=SINGULAR|gender=FEMININE|case=NOMINATIVE	
ferit	ferio	VB	person=PERSON_3|number=SINGULAR|tense=PR|mood=INDICATIVE|voice=ACTIVE	
quotiens	quotiens	ADV	_	
rimosa	rimosus	ADJ	number=PLURAL|gender=NEUTER|case=NOMINATIVE	
et	et	CONJ	_	
curta	curtus	ADJ	number=PLURAL|gender=NEUTER|case=NOMINATIVE	
fenestris	fenestra	NN	number=PLURAL|gender=FEMININE|case=ABLATIVE	
vasa	vasum	NN	number=PLURAL|gender=NEUTER|case=NOMINATIVE	
cadant	cado	VB	person=PERSON_3|number=PLURAL|tense=PR|mood=SUBJUNCTIVE|voice=ACTIVE	
quanto	quantus	ADJ	number=SINGULAR|gender=NEUTER|case=ABLATIVE	
percussum	percussus	NN	number=SINGULAR|gender=MASCULINE|case=ACCUSATIVE	
pondere	pondus	NN	number=SINGULAR|gender=NEUTER|case=ABLATIVE	
signent	signo	VB	person=PERSON_3|number=PLURAL|tense=PR|mood=SUBJUNCTIVE|voice=ACTIVE	
et	et	CONJ	_	
laedant	laedo	VB	person=PERSON_3|number=PLURAL|tense=PR|mood=SUBJUNCTIVE|voice=ACTIVE	
silicem	silex	NN	number=SINGULAR|gender=MASCULINE|case=ACCUSATIVE	
.	unknown		_	
si	si	CONJ	_	
dixeris	dico	VB	person=PERSON_2|number=SINGULAR|tense=PERF|mood=SUBJUNCTIVE|voice=ACTIVE	
aestuo	aestuo	VB	person=PERSON_1|number=SINGULAR|tense=PR|mood=INDICATIVE|voice=ACTIVE	
,	unknown		_	
'	unknown		_	
sudat	sudo	VB	person=PERSON_3|number=SINGULAR|tense=PR|mood=INDICATIVE|voice=ACTIVE	
iam	jam	ADV	_	
pridem	pridem	ADV	_	
Syrus	syrus	ADJ	number=SINGULAR|gender=MASCULINE|case=NOMINATIVE	
in	in	PREP	_	
Tiberim	Tiberis	NN	number=SINGULAR|gender=MASCULINE|case=ACCUSATIVE	
defluxit	defluo	VB	person=PERSON_3|number=SINGULAR|tense=PERF|mood=INDICATIVE|voice=ACTIVE	
Orontes	Orontes	NN	number=SINGULAR|gender=MASCULINE|case=NOMINATIVE	
et	et	CONJ	_	
linguam	lingua	NN	number=SINGULAR|gender=FEMININE|case=ACCUSATIVE	
et	et	CONJ	_	
mores	mos	NN	number=PLURAL|gender=MASCULINE|case=ACCUSATIVE	
et	et	CONJ	_	
cum	cum	PREP	_	
tibicine	tibicen	NN	number=SINGULAR|gender=MASCULINE|case=ABLATIVE	
chordas	chorda	NN	number=PLURAL|gender=FEMININE|case=ACCUSATIVE	
obliquas	obliquus	ADJ	number=PLURAL|gender=FEMININE|case=ACCUSATIVE	
ne	ne	ADV	_	
-c	que	CONJ	_	
non	non	ADV	_	
gentilia	gentilis	ADJ	number=PLURAL|gender=NEUTER|case=ACCUSATIVE	
tympana	tympanum	NN	number=PLURAL|gender=NEUTER|case=ACCUSATIVE	
se	sui	PRON	number=SINGULAR|gender=MASCULINE|case=ABLATIVE	
-cum	cum	PREP	_	
vexit	veho	VB	person=PERSON_3|number=SINGULAR|tense=PERF|mood=INDICATIVE|voice=ACTIVE	
et	et	CONJ	_	
ad	ad	PREP	_	
circum	circus	NN	number=SINGULAR|gender=MASCULINE|case=ACCUSATIVE	
iussas	jubeo	VB	number=PLURAL|tense=PERF|mood=PARTICIPLE|voice=PASSIVE|gender=FEMININE|case=ACCUSATIVE	
prostare	prosto	VB	tense=PR|mood=INFINITIVE|voice=ACTIVE	
puellas	puella	NN	number=PLURAL|gender=FEMININE|case=ACCUSATIVE	
lectus	lectus	NN	number=SINGULAR|gender=MASCULINE|case=NOMINATIVE	
erat	sum	VB	person=PERSON_3|number=SINGULAR|tense=IMP|mood=INDICATIVE|voice=ACTIVE	
Codro	Codrus	NN	number=SINGULAR|gender=MASCULINE|case=DATIVE	
Procula	Procula	NN	number=SINGULAR|gender=FEMININE|case=ABLATIVE	
minor	parvus	ADJ	number=SINGULAR|gender=MASCULINE|case=NOMINATIVE|degree=COMPARATIVE	
,	unknown		_	
urceoli	urceolus	NN	number=PLURAL|gender=MASCULINE|case=NOMINATIVE	
sex	sex	NRL	_	
ornamentum	ornamentum	NN	number=SINGULAR|gender=NEUTER|case=NOMINATIVE	
abaci	abacus	NN	number=SINGULAR|gender=MASCULINE|case=GENITIVE	
ne	ne	ADV	_	
-c	que	CONJ	_	
non	non	ADV	_	
et	et	CONJ	_	
parvulus	parvulus	ADJ	number=SINGULAR|gender=MASCULINE|case=NOMINATIVE	
infra	infra	ADV	_	
cantharus	cantharus	NN	number=SINGULAR|gender=MASCULINE|case=NOMINATIVE	
et	et	CONJ	_	
recubans	recubo	VB	number=SINGULAR|tense=PR|mood=PARTICIPLE|gender=MASCULINE|case=NOMINATIVE	
sub	sub	PREP	_	
eodem	idem	PRON	number=SINGULAR|gender=NEUTER|case=ABLATIVE	
marmore	marmor	NN	number=SINGULAR|gender=MASCULINE|case=ABLATIVE	
Chiron	Chiron	NN	number=SINGULAR|gender=MASCULINE|case=NOMINATIVE	
,	unknown		_	
iam	jam	ADV	_	
-que	que	CONJ	_	
vetus	vetus	ADJ	number=SINGULAR|gender=FEMININE|case=NOMINATIVE	
graecos	Graecus	ADJ	number=PLURAL|gender=MASCULINE|case=ACCUSATIVE	
servabat	servo	VB	person=PERSON_3|number=SINGULAR|tense=IMP|mood=INDICATIVE|voice=ACTIVE	
cista	cista	NN	number=SINGULAR|gender=FEMININE|case=NOMINATIVE	
libellos	libellus	NN	number=PLURAL|gender=MASCULINE|case=ACCUSATIVE	
et	et	CONJ	_	
divina	divinus	ADJ	number=PLURAL|gender=NEUTER|case=ACCUSATIVE	
opici	opicus	ADJ	number=PLURAL|gender=MASCULINE|case=NOMINATIVE	
rodebant	rodo	VB	person=PERSON_3|number=PLURAL|tense=IMP|mood=INDICATIVE|voice=ACTIVE	
carmina	carmen	NN	number=PLURAL|gender=NEUTER|case=ACCUSATIVE	
mures	mus	NN	number=PLURAL|gender=MASCULINE|case=NOMINATIVE	
.	unknown		_	
quis	quis	PRON	number=SINGULAR|gender=MASCULINE|case=NOMINATIVE	
nunc	nunc	ADV	_	
diligitur	diligo	VB	person=PERSON_3|number=SINGULAR|tense=PR|mood=INDICATIVE|voice=PASSIVE	
ni	ni	ADV	_	
-si	nisi	CONJ	_	
conscius	conscius	ADJ	number=SINGULAR|gender=MASCULINE|case=NOMINATIVE	
et	et	CONJ	_	
cui	qui	PRON	number=SINGULAR|gender=MASCULINE|case=DATIVE	
fervens	ferveo	VB	number=SINGULAR|tense=PR|mood=PARTICIPLE|gender=MASCULINE|case=NOMINATIVE	
aestuat	aestuo	VB	person=PERSON_3|number=SINGULAR|tense=PR|mood=INDICATIVE|voice=ACTIVE	
occultis	occulo	VB	number=PLURAL|tense=PERF|mood=PARTICIPLE|voice=PASSIVE|gender=NEUTER|case=ABLATIVE	
animus	animus	NN	number=SINGULAR|gender=MASCULINE|case=NOMINATIVE	
semper	semper	ADV	_	
-que	que	CONJ	_	
tacendis	taceo	VB	number=PLURAL|mood=GERUNDIVE|gender=NEUTER|case=ABLATIVE	
nam	nam	ADV	_	
si	si	CONJ	_	
procubuit	procumbo	VB	person=PERSON_3|number=SINGULAR|tense=PERF|mood=INDICATIVE|voice=ACTIVE	
qui	qui	PRON	number=SINGULAR|gender=MASCULINE|case=NOMINATIVE	
saxa	saxum	NN	number=PLURAL|gender=NEUTER|case=ACCUSATIVE	
Ligustica	Liguticus	ADJ	number=PLURAL|gender=NEUTER|case=ACCUSATIVE	
portat	porto	VB	person=PERSON_3|number=SINGULAR|tense=PR|mood=INDICATIVE|voice=ACTIVE	
axis	axis	NN	number=SINGULAR|gender=MASCULINE|case=NOMINATIVE	
et	et	CONJ	_	
eversum	everto	VB	number=SINGULAR|tense=PERF|mood=PARTICIPLE|voice=PASSIVE|gender=MASCULINE|case=ACCUSATIVE	
fudit	fundo	VB	person=PERSON_3|number=SINGULAR|tense=PERF|mood=INDICATIVE|voice=ACTIVE	
super	super	PREP	_	
agmina	agmen	NN	number=PLURAL|gender=NEUTER|case=ACCUSATIVE	
montem	mons	NN	number=SINGULAR|gender=MASCULINE|case=ACCUSATIVE	
quid	quis	PRON	number=SINGULAR|gender=NEUTER|case=NOMINATIVE	
superest	supersum	VB	person=PERSON_3|number=SINGULAR|tense=PR|mood=INDICATIVE|voice=ACTIVE	
de	de	PREP	_	
corporibus	corpus	NN	number=PLURAL|gender=NEUTER|case=ABLATIVE	
nos	nos	PRON	number=PLURAL|gender=MASCULINE|case=NOMINATIVE	
urbem	urbs	NN	number=SINGULAR|gender=FEMININE|case=ACCUSATIVE	
colimus	colo	VB	person=PERSON_1|number=PLURAL|tense=PR|mood=INDICATIVE|voice=ACTIVE	
tenui	tenuis	ADJ	number=SINGULAR|gender=MASCULINE|case=ABLATIVE	
tibicine	tibicen	NN	number=SINGULAR|gender=MASCULINE|case=ABLATIVE	
fultam	fulcio	VB	number=SINGULAR|tense=PERF|mood=PARTICIPLE|voice=PASSIVE|gender=FEMININE|case=ACCUSATIVE	
magna	magnus	ADJ	number=SINGULAR|gender=FEMININE|case=ABLATIVE	
parte	pars	NN	number=SINGULAR|gender=FEMININE|case=ABLATIVE	
sui	sui	PRON	number=SINGULAR|gender=FEMININE|case=GENITIVE	
commune	communis	ADJ	number=SINGULAR|gender=NEUTER|case=NOMINATIVE	
id	is	PRON	number=SINGULAR|gender=NEUTER|case=NOMINATIVE	
vitium	vitium	NN	number=SINGULAR|gender=NEUTER|case=NOMINATIVE	
est	sum	VB	person=PERSON_3|number=SINGULAR|tense=PR|mood=INDICATIVE|voice=ACTIVE	
,	unknown		_	
hic	hic	ADV	_	
vivimus	vivo	VB	person=PERSON_1|number=PLURAL|tense=PR|mood=INDICATIVE|voice=ACTIVE	
ambitiosa	ambitiosus	ADJ	number=SINGULAR|gender=FEMININE|case=ABLATIVE	
paupertate	paupertas	NN	number=SINGULAR|gender=FEMININE|case=ABLATIVE	
omnes	omnis	ADJ	number=PLURAL|gender=MASCULINE|case=NOMINATIVE	
.	unknown		_	
pinguia	pinguis	ADJ	number=PLURAL|gender=NEUTER|case=NOMINATIVE	
crura	crus	NN	number=PLURAL|gender=NEUTER|case=NOMINATIVE	
luto	lutum	NN	number=SINGULAR|gender=NEUTER|case=ABLATIVE	
planta	planta	NN	number=SINGULAR|gender=FEMININE|case=ABLATIVE	
mox	mox	ADV	_	
undique	undique	ADV	_	
magna	magnus	ADJ	number=SINGULAR|gender=FEMININE|case=ABLATIVE	
calcor	calco	VB	person=PERSON_1|number=SINGULAR|tense=PR|mood=INDICATIVE|voice=PASSIVE	
et	et	CONJ	_	
in	in	PREP	_	
digito	digitus	NN	number=SINGULAR|gender=MASCULINE|case=ABLATIVE	
clavus	clavus	NN	number=SINGULAR|gender=MASCULINE|case=NOMINATIVE	
mihi	ego	PRON	number=SINGULAR|gender=MASCULINE|case=DATIVE	
militis	miles	NN	number=SINGULAR|gender=MASCULINE|case=GENITIVE	
haeret	haereo	VB	person=PERSON_3|number=SINGULAR|tense=PR|mood=INDICATIVE|voice=ACTIVE	
"	unknown		_	
Si	si	CONJ	_	
magna	magnus	ADJ	number=SINGULAR|gender=FEMININE|case=NOMINATIVE	
Asturici	Asturicus	NN	number=SINGULAR|gender=MASCULINE|case=GENITIVE	
cecidit	cado	VB	person=PERSON_3|number=SINGULAR|tense=PERF|mood=INDICATIVE|voice=ACTIVE	
domus	domus	NN	number=SINGULAR|gender=FEMININE|case=NOMINATIVE	
horrida	horridus	ADJ	number=SINGULAR|gender=FEMININE|case=NOMINATIVE	
mater	mater	NN	number=SINGULAR|gender=FEMININE|case=NOMINATIVE	
pullati	pullatus	ADJ	number=PLURAL|gender=MASCULINE|case=NOMINATIVE	
proceres	proceres	VB	person=PERSON_2|number=SINGULAR|tense=PR|mood=SUBJUNCTIVE|voice=ACTIVE	
differt	differo	VB	person=PERSON_3|number=SINGULAR|tense=PR|mood=INDICATIVE|voice=ACTIVE	
vadimonia	vadimonium	NN	number=PLURAL|gender=NEUTER|case=ACCUSATIVE	
praetor	praetor	NN	number=SINGULAR|gender=MASCULINE|case=NOMINATIVE	
.	unknown		_	
quot	quot	ADV	_	
pascit	pasco	VB	person=PERSON_3|number=SINGULAR|tense=PR|mood=INDICATIVE|voice=ACTIVE	
servos	servus	ADJ	number=PLURAL|gender=MASCULINE|case=ACCUSATIVE	
agmine	agmen	NN	number=SINGULAR|gender=NEUTER|case=ABLATIVE	
facto	facio	VB	number=SINGULAR|tense=PERF|mood=PARTICIPLE|voice=PASSIVE|gender=NEUTER|case=ABLATIVE	
debuerant	debeo	VB	person=PERSON_3|number=PLURAL|tense=PLUSQUAMPERFECT|mood=INDICATIVE|voice=ACTIVE	
olim	olim	ADV	_	
tenues	tenuis	ADJ	number=PLURAL|gender=MASCULINE|case=NOMINATIVE	
migrasse	migro	VB	tense=PERF|mood=INFINITIVE|voice=ACTIVE	
Quirites	quiris	NN	number=PLURAL|gender=MASCULINE|case=NOMINATIVE	
hic	hic	ADV	_	
plaudat	plaudo	VB	person=PERSON_3|number=SINGULAR|tense=PR|mood=SUBJUNCTIVE|voice=ACTIVE	
nitidi	nitidus	ADJ	number=SINGULAR|gender=MASCULINE|case=GENITIVE	
praeconis	praeco	NN	number=SINGULAR|gender=MASCULINE|case=GENITIVE	
filius	filius	NN	number=SINGULAR|gender=MASCULINE|case=NOMINATIVE	
inter	inter	PREP	_	
pinnirapi	pinnirapus	NN	number=SINGULAR|gender=MASCULINE|case=GENITIVE	
cultos	colo		number=PLURAL|tense=PERF|mood=PARTICIPLE|voice=PASSIVE|gender=MASCULINE|case=ACCUSATIVE	
iuvenes	juvenis	ADJ	number=PLURAL|gender=MASCULINE|case=ACCUSATIVE	
iuvenes	juvenis	ADJ	number=PLURAL|gender=MASCULINE|case=ACCUSATIVE	
-que	que	CONJ	_	
lanistae	lanista	NN	number=SINGULAR|gender=MASCULINE|case=GENITIVE	
:	unknown		_	
me	ego	PRON	number=SINGULAR|gender=MASCULINE|case=ACCUSATIVE	
quem	qui	PRON	number=SINGULAR|gender=MASCULINE|case=ACCUSATIVE	
Luna	luna	NN	number=SINGULAR|gender=FEMININE|case=NOMINATIVE	
solet	soleo	VB	person=PERSON_3|number=SINGULAR|tense=PR|mood=INDICATIVE|voice=ACTIVE	
deducere	deduco	VB	tense=PR|mood=INFINITIVE|voice=ACTIVE	
vel	vel	CONJ	_	
breve	brevis	ADJ	number=SINGULAR|gender=NEUTER|case=NOMINATIVE	
lumen	lumen	NN	number=SINGULAR|gender=NEUTER|case=NOMINATIVE	
candelae	candela	NN	number=SINGULAR|gender=FEMININE|case=GENITIVE	
cuius	qui	PRON	number=SINGULAR|gender=FEMININE|case=GENITIVE	
dispenso	dispenso	VB	person=PERSON_1|number=SINGULAR|tense=PR|mood=INDICATIVE|voice=ACTIVE	
et	et	CONJ	_	
tempero	tempero	VB	person=PERSON_1|number=SINGULAR|tense=PR|mood=INDICATIVE|voice=ACTIVE	
filum	filum	NN	number=SINGULAR|gender=NEUTER|case=ACCUSATIVE	
contemnit	contemno	VB	person=PERSON_3|number=SINGULAR|tense=PR|mood=INDICATIVE|voice=ACTIVE	
.	unknown		_	
"	unknown		_	
Nonne	nonne	ADV	_	
vides	video	VB	person=PERSON_2|number=SINGULAR|tense=PR|mood=INDICATIVE|voice=ACTIVE	
quanto	quantus	ADJ	number=SINGULAR|gender=MASCULINE|case=ABLATIVE	
celebretur	celebro	VB	person=PERSON_3|number=SINGULAR|tense=PR|mood=SUBJUNCTIVE|voice=PASSIVE	
sportula	sportula	NN	number=SINGULAR|gender=FEMININE|case=NOMINATIVE	
fumo	fumus	NN	number=SINGULAR|gender=MASCULINE|case=ABLATIVE	
igniculum	igniculus	NN	number=SINGULAR|gender=MASCULINE|case=ACCUSATIVE	
brumae	bruma	NN	number=SINGULAR|gender=FEMININE|case=GENITIVE	
si	si	CONJ	_	
tempore	tempus	NN	number=SINGULAR|gender=NEUTER|case=ABLATIVE	
poscas	posco	VB	person=PERSON_2|number=SINGULAR|tense=PR|mood=SUBJUNCTIVE|voice=ACTIVE	
accipit	accipio	VB	person=PERSON_3|number=SINGULAR|tense=PR|mood=INDICATIVE|voice=ACTIVE	
endromidem	endromis	NN	number=SINGULAR|gender=FEMININE|case=ACCUSATIVE	
unde	unde	ADV	_	
venis	venio	VB	person=PERSON_2|number=SINGULAR|tense=PR|mood=INDICATIVE|voice=ACTIVE	
'	unknown		_	
exclamat	exclamo	VB	person=PERSON_3|number=SINGULAR|tense=PR|mood=INDICATIVE|voice=ACTIVE	
'	unknown		_	
cuius	qui	PRON	number=SINGULAR|gender=MASCULINE|case=GENITIVE	
aceto	acetum	NN	number=SINGULAR|gender=NEUTER|case=ABLATIVE	
,			_	
cuius	qui	PRON	number=SINGULAR|gender=MASCULINE|case=GENITIVE	
conche	conchis	NN	number=SINGULAR|gender=FEMININE|case=ABLATIVE	
tumes	tumeo	VB	person=PERSON_2|number=SINGULAR|tense=PR|mood=INDICATIVE|voice=ACTIVE	
nam	nam	ADV	_	
sic	sic	ADV	_	
labentibus	labor	VB	number=PLURAL|tense=PR|mood=PARTICIPLE|gender=NEUTER|case=DATIVE	
obstat	obsto	VB	person=PERSON_3|number=SINGULAR|tense=PR|mood=INDICATIVE|voice=ACTIVE	
vilicus	vilicus	NN	number=SINGULAR|gender=MASCULINE|case=NOMINATIVE	
et	et	CONJ	_	
veteris	vetus	ADJ	number=SINGULAR|gender=FEMININE|case=GENITIVE	
rimae	rima	NN	number=SINGULAR|gender=FEMININE|case=GENITIVE	
cum	Cum	CONJ	_	
texit	tego	VB	person=PERSON_3|number=SINGULAR|tense=PERF|mood=INDICATIVE|voice=ACTIVE	
hiatum	hiatus	NN	number=SINGULAR|gender=MASCULINE|case=ACCUSATIVE	
securos	securus	ADJ	number=PLURAL|gender=MASCULINE|case=ACCUSATIVE	
pendente	pendeo	VB	number=SINGULAR|tense=PR|mood=PARTICIPLE|gender=FEMININE|case=ABLATIVE	
iubet	jubeo	VB	person=PERSON_3|number=SINGULAR|tense=PR|mood=INDICATIVE|voice=ACTIVE	
dormire	dormio	VB	tense=PR|mood=INFINITIVE|voice=ACTIVE	
ruina	ruina	NN	number=SINGULAR|gender=FEMININE|case=ABLATIVE	
.	unknown		_	
at	at	CONJ	_	
tu	tu	PRON	number=SINGULAR|gender=MASCULINE|case=NOMINATIVE	
cum	Cum	CONJ	_	
tibi	tu	PRON	number=SINGULAR|gender=MASCULINE|case=DATIVE	
vestiti	vestio	VB	number=SINGULAR|tense=PERF|mood=PARTICIPLE|voice=PASSIVE|gender=NEUTER|case=GENITIVE	
facies	facies	NN	number=SINGULAR|gender=FEMININE|case=NOMINATIVE	
scorti	scortum	NN	number=SINGULAR|gender=NEUTER|case=GENITIVE	
placet	placeo	VB	person=PERSON_3|number=SINGULAR|tense=PR|mood=INDICATIVE|voice=ACTIVE	
haeres	haereo	VB	person=PERSON_2|number=SINGULAR|tense=PR|mood=INDICATIVE|voice=ACTIVE	
et	et	CONJ	_	
dubitas	dubito	VB	person=PERSON_2|number=SINGULAR|tense=PR|mood=INDICATIVE|voice=ACTIVE	
alta	altus	ADJ	number=SINGULAR|gender=FEMININE|case=ABLATIVE	
Chionen	Chione	NN	number=SINGULAR|gender=FEMININE|case=ACCUSATIVE	
deducere	deduco	VB	tense=PR|mood=INFINITIVE|voice=ACTIVE	
sella	sella	NN	number=SINGULAR|gender=FEMININE|case=ABLATIVE	
.	unknown		_	
nam	nam	ADV	_	
quae	qui	PRON	number=PLURAL|gender=NEUTER|case=NOMINATIVE	
meritoria	meritorius	ADJ	number=PLURAL|gender=NEUTER|case=NOMINATIVE	
somnum	somnus	NN	number=SINGULAR|gender=MASCULINE|case=ACCUSATIVE	
admittunt	admitto	VB	person=PERSON_3|number=PLURAL|tense=PR|mood=INDICATIVE|voice=ACTIVE	
funus	funus	NN	number=SINGULAR|gender=NEUTER|case=ACCUSATIVE	
promittere	promitto	VB	tense=PR|mood=INFINITIVE|voice=ACTIVE	
patris	pater	NN	number=SINGULAR|gender=MASCULINE|case=GENITIVE	
ne	ne	ADV	_	
-c	que	CONJ	_	
volo	volo	VB	person=PERSON_1|number=SINGULAR|tense=PR|mood=INDICATIVE|voice=ACTIVE	
ne	ne	ADV	_	
-c	que	CONJ	_	
possum	possum	VB	person=PERSON_1|number=SINGULAR|tense=PR|mood=INDICATIVE|voice=ACTIVE	
quis	quis	PRON	number=SINGULAR|gender=MASCULINE|case=NOMINATIVE	
pauper	pauper	NN	number=SINGULAR|gender=MASCULINE|case=NOMINATIVE	
scribitur	scribo	VB	person=PERSON_3|number=SINGULAR|tense=PR|mood=INDICATIVE|voice=PASSIVE	
heres	heres	NN	number=SINGULAR|gender=MASCULINE|case=NOMINATIVE	
nil	nihil	NN	number=SINGULAR|gender=NEUTER	
tibi	tu	PRON	number=SINGULAR|gender=MASCULINE|case=DATIVE	
se	sui	PRON	number=PLURAL|gender=MASCULINE|case=ACCUSATIVE	
debere	debeo	VB	tense=PR|mood=INFINITIVE|voice=ACTIVE	
putat	puto	VB	person=PERSON_3|number=SINGULAR|tense=PR|mood=INDICATIVE|voice=ACTIVE	
,	comma	CONJ	_	
nil	nihil	NN	number=SINGULAR|gender=NEUTER	
conferet	confero	VB	person=PERSON_3|number=SINGULAR|tense=FUTURE|mood=INDICATIVE|voice=ACTIVE	
umquam	umquam	ADV	_	
participem	participo	VB	person=PERSON_1|number=SINGULAR|tense=PR|mood=SUBJUNCTIVE|voice=ACTIVE	
qui	qui	PRON	number=SINGULAR|gender=MASCULINE|case=NOMINATIVE	
te	tu	PRON	number=SINGULAR|gender=MASCULINE|case=ACCUSATIVE	
secreti	secretum	NN	number=SINGULAR|gender=NEUTER|case=GENITIVE	
fecit	facio	VB	person=PERSON_3|number=SINGULAR|tense=PERF|mood=INDICATIVE|voice=ACTIVE	
honesti	honestus	ADJ	number=SINGULAR|gender=NEUTER|case=GENITIVE	
quis	quis	PRON	number=SINGULAR|gender=MASCULINE|case=NOMINATIVE	
enim	enim	ADV	_	
negat	nego	VB	person=PERSON_3|number=SINGULAR|tense=PR|mood=INDICATIVE|voice=ACTIVE	
in	in	PREP	_	
vallem	valles	NN	number=SINGULAR|gender=FEMININE|case=ACCUSATIVE	
Egeriae	Egeria	NN	number=SINGULAR|gender=FEMININE|case=GENITIVE	
descendimus	descendo	VB	person=PERSON_1|number=PLURAL|tense=PERF|mood=INDICATIVE|voice=ACTIVE	
et	et	CONJ	_	
speluncas	spelunca	NN	number=PLURAL|gender=FEMININE|case=ACCUSATIVE	
dissimiles	dissimilis	ADJ	number=PLURAL|gender=FEMININE|case=ACCUSATIVE	
veris	verus	ADJ	number=PLURAL|gender=FEMININE|case=DATIVE	
.	period		_	
quis	quis	PRON	number=SINGULAR|gender=MASCULINE|case=NOMINATIVE	
membra	membrum	NN	number=PLURAL|gender=NEUTER|case=ACCUSATIVE	
,			_	
quis	quis	PRON	number=SINGULAR|gender=MASCULINE|case=NOMINATIVE	
ossa	os	NN	number=PLURAL|gender=NEUTER|case=ACCUSATIVE	
invenit	invenio	VB	person=PERSON_3|number=SINGULAR|tense=PR|mood=INDICATIVE|voice=ACTIVE	
"	unknown		_	
Plurimus	multus	ADJ	number=SINGULAR|gender=MASCULINE|case=NOMINATIVE	
hic	hic	ADV	_	
aeger	aeger	ADJ	number=SINGULAR|gender=MASCULINE|case=NOMINATIVE	
moritur	morior	VB	person=PERSON_3|number=SINGULAR|tense=PR|mood=INDICATIVE|voice=PASSIVE	
vigilando	vigilo	VB	number=SINGULAR|tense=PR|mood=GERUND|voice=ACTIVE|case=ABLATIVE	
set	sed	CONJ	_	
ipsum	ipse	PRON	number=SINGULAR|gender=MASCULINE|case=ACCUSATIVE	
languorem	languor	NN	number=SINGULAR|gender=MASCULINE|case=ACCUSATIVE	
peperit	pario	VB	person=PERSON_3|number=SINGULAR|tense=PERF|mood=INDICATIVE|voice=ACTIVE	
cibus	cibus	NN	number=SINGULAR|gender=MASCULINE|case=NOMINATIVE	
inperfectus	imperfectus	ADJ	number=SINGULAR|gender=MASCULINE|case=NOMINATIVE	
et	et	CONJ	_	
haerens	haereo	VB	number=SINGULAR|tense=PR|mood=PARTICIPLE|gender=MASCULINE|case=NOMINATIVE	
ardenti	ardeo	VB	number=SINGULAR|tense=PR|mood=PARTICIPLE|gender=MASCULINE|case=ABLATIVE	
stomacho	stomachus	NN	number=SINGULAR|gender=MASCULINE|case=ABLATIVE	
.	unknown		_	
"	unknown		_	
Ne	ne	ADV	_	
-c	que	CONJ	_	
tamen	tamen	ADV	_	
haec	hic	ADJ	number=PLURAL|gender=NEUTER|case=ACCUSATIVE	
tantum	tantus	ADV	_	
metuas	metuo	VB	person=PERSON_2|number=SINGULAR|tense=PR|mood=SUBJUNCTIVE|voice=ACTIVE	
.	unknown		_	
felices	felix	ADJ	number=PLURAL|gender=MASCULINE|case=ACCUSATIVE	
proavorum	proavus	NN	number=PLURAL|gender=MASCULINE|case=GENITIVE	
atavos	atavus	NN	number=PLURAL|gender=MASCULINE|case=ACCUSATIVE	
,			_	
felicia	felix	ADJ	number=PLURAL|gender=NEUTER|case=ACCUSATIVE	
dicas	dico	VB	person=PERSON_2|number=SINGULAR|tense=PR|mood=SUBJUNCTIVE|voice=ACTIVE	
saecula	saeculum	NN	number=PLURAL|gender=NEUTER|case=ACCUSATIVE	
quae	qui	PRON	number=PLURAL|gender=NEUTER|case=NOMINATIVE	
quondam	quondam	ADV	_	
sub	sub	PREP	_	
regibus	rex	NN	number=PLURAL|gender=MASCULINE|case=ABLATIVE	
atque	atque	CONJ	_	
tribunis	tribunus	NN	number=PLURAL|gender=MASCULINE|case=ABLATIVE	
viderunt	video	VB	person=PERSON_3|number=PLURAL|tense=PERF|mood=INDICATIVE|voice=ACTIVE	
uno	unus	ADJ	number=SINGULAR|gender=MASCULINE|case=ABLATIVE	
contentam	contineo	VB	number=SINGULAR|tense=PERF|mood=PARTICIPLE|voice=PASSIVE|gender=FEMININE|case=ACCUSATIVE	
carcere	carcer	NN	number=SINGULAR|gender=MASCULINE|case=ABLATIVE	
Romam	Roma	NN	number=SINGULAR|gender=FEMININE|case=ACCUSATIVE	
et	et	CONJ	_	
tamen	tamen	ADV	_	
illud	ille	PRON	number=SINGULAR|gender=NEUTER|case=ACCUSATIVE	
perdidit	perdo	VB	person=PERSON_3|number=SINGULAR|tense=PERF|mood=INDICATIVE|voice=ACTIVE	
infelix	infelix	ADJ	number=SINGULAR|gender=MASCULINE|case=NOMINATIVE	
totum	totus	ADJ	number=SINGULAR|gender=NEUTER|case=ACCUSATIVE	
nihil	nihil	NN	number=SINGULAR|gender=NEUTER|case=ACCUSATIVE	
.	unknown		_	
"	unknown		_	
Praeterea	praeterea	ADV	_	
sanctum	sancio	VB	number=SINGULAR|tense=PERF|mood=PARTICIPLE|voice=PASSIVE|gender=NEUTER|case=NOMINATIVE	
nihil	nihil	NN	number=SINGULAR|gender=NEUTER|case=NOMINATIVE	
est	sum	VB	person=PERSON_3|number=SINGULAR|tense=PR|mood=INDICATIVE|voice=ACTIVE	
ne	ne	ADV	_	
-que	que	CONJ	_	
ab	ab	PREP	_	
inguine	inguen	NN	number=SINGULAR|gender=NEUTER|case=ABLATIVE	
tutum	tueor	VB	number=SINGULAR|tense=PERF|mood=PARTICIPLE|voice=PASSIVE|gender=NEUTER|case=NOMINATIVE	
,	comma	CONJ	_	
non	non	ADV	_	
matrona	matrona	NN	number=SINGULAR|gender=FEMININE|case=NOMINATIVE	
Laris	Lar	NN	number=SINGULAR|gender=MASCULINE|case=GENITIVE	
non	non	ADV	_	
filia	filia	NN	number=SINGULAR|gender=FEMININE|case=NOMINATIVE	
virgo	virgo	NN	number=SINGULAR|gender=FEMININE|case=NOMINATIVE	
ne	ne	ADV	_	
-que	que	CONJ	_	
ipse	ipse	PRON	number=SINGULAR|gender=MASCULINE|case=NOMINATIVE	
sponsus	sponsus	NN	number=SINGULAR|gender=MASCULINE|case=NOMINATIVE	
levis	levis	ADJ	number=SINGULAR|gender=MASCULINE|case=NOMINATIVE	
adhuc	adhuc	ADV	_	
non	non	ADV	_	
filius	filius	NN	number=SINGULAR|gender=MASCULINE|case=NOMINATIVE	
ante	ante	ADV	_	
pudicus	pudicus	ADJ	number=SINGULAR|gender=MASCULINE|case=NOMINATIVE	
quanto	quantus	ADJ	number=SINGULAR|gender=NEUTER|case=ABLATIVE	
praesentius	praesens	ADJ	number=SINGULAR|gender=NEUTER|case=NOMINATIVE|degree=COMPARATIVE	
esset	sum	VB	person=PERSON_3|number=SINGULAR|tense=IMP|mood=SUBJUNCTIVE|voice=ACTIVE	
numen	numen	NN	number=SINGULAR|gender=NEUTER|case=NOMINATIVE	
aquis	aqua	NN	number=PLURAL|gender=FEMININE|case=DATIVE	
viridi	viridis	ADJ	number=SINGULAR|gender=FEMININE|case=ABLATIVE	
si	si	CONJ	_	
margine	margo	NN	number=SINGULAR|gender=FEMININE|case=ABLATIVE	
clauderet	claudo	VB	person=PERSON_3|number=SINGULAR|tense=IMP|mood=SUBJUNCTIVE|voice=ACTIVE	
undas	unda	NN	number=PLURAL|gender=FEMININE|case=ACCUSATIVE	
herba	herba	NN	number=SINGULAR|gender=FEMININE|case=NOMINATIVE	
ne	ne	ADV	_	
-c	que	CONJ	_	
ingenuum	ingenuus	ADJ	number=SINGULAR|gender=MASCULINE|case=ACCUSATIVE	
violarent	violo	VB	person=PERSON_3|number=PLURAL|tense=IMP|mood=SUBJUNCTIVE|voice=ACTIVE	
marmora	marmoro	VB	person=PERSON_2|number=SINGULAR|tense=PR|mood=IMPERATIVE|voice=ACTIVE	
tofum	tofus	NN	number=SINGULAR|gender=MASCULINE|case=ACCUSATIVE	
inde	inde	ADV	_	
caput	caput	NN	number=SINGULAR|gender=NEUTER|case=NOMINATIVE	
morbi	morbus	NN	number=SINGULAR|gender=MASCULINE|case=GENITIVE	
.	unknown		_	
non	non	ADV	_	
est	sum	VB	person=PERSON_3|number=SINGULAR|tense=PR|mood=INDICATIVE|voice=ACTIVE	
Romano	Romanus	ADJ	number=SINGULAR|gender=MASCULINE|case=DATIVE	
cuiquam	quisquam	PRON	number=SINGULAR|gender=MASCULINE|case=DATIVE	
locus	locus	NN	number=SINGULAR|gender=MASCULINE|case=NOMINATIVE	
hic	hic	ADV	_	
ubi	ubi	CONJ	_	
regnat	regno	VB	person=PERSON_3|number=SINGULAR|tense=PR|mood=INDICATIVE|voice=ACTIVE	
Protogenes	Protogenes	NN	number=SINGULAR|gender=MASCULINE|case=NOMINATIVE	
aliquis	aliquis	PRON	number=SINGULAR|gender=MASCULINE|case=NOMINATIVE	
vel	vel	CONJ	_	
Diphilus	Diphilus	NN	number=SINGULAR|gender=MASCULINE|case=NOMINATIVE	
aut	aut	CONJ	_	
Hermarchus	Hermarchus	NN	number=SINGULAR|gender=MASCULINE|case=NOMINATIVE	
qui	qui	PRON	number=SINGULAR|gender=MASCULINE|case=NOMINATIVE	
gentis	gens	NN	number=SINGULAR|gender=FEMININE|case=GENITIVE	
vitio	vitium	NN	number=SINGULAR|gender=NEUTER|case=ABLATIVE	
numquam	numquam	ADV	_	
partitur	partior	VB	person=PERSON_3|number=SINGULAR|tense=PR|mood=INDICATIVE|voice=PASSIVE	
amicum	amicus	NN	number=SINGULAR|gender=MASCULINE|case=ACCUSATIVE	
,	comma	CONJ	_	
solus	solus	NN	number=SINGULAR|gender=MASCULINE|case=NOMINATIVE	
habet	habeo	VB	person=PERSON_3|number=SINGULAR|tense=PR|mood=INDICATIVE|voice=ACTIVE	
.	unknown		_	
in	in	PREP	_	
caelum	caelum	NN	number=SINGULAR|gender=NEUTER|case=ACCUSATIVE	
iusseris	jubeo	VB	person=PERSON_2|number=SINGULAR|tense=FUTUREPERFECT|mood=INDICATIVE|voice=ACTIVE	
ibit	eo	VB	person=PERSON_3|number=SINGULAR|tense=FUTURE|mood=INDICATIVE|voice=ACTIVE	
tanti	tantus	ADJ	number=SINGULAR|gender=NEUTER|case=GENITIVE	
tibi	tu	PRON	number=SINGULAR|gender=MASCULINE|case=DATIVE	
non	non	ADV	_	
sit	sum	VB	person=PERSON_3|number=SINGULAR|tense=PR|mood=SUBJUNCTIVE|voice=ACTIVE	
opaci	opacus	ADJ	number=SINGULAR|gender=MASCULINE|case=GENITIVE	
omnis	omnis	ADJ	number=SINGULAR|gender=FEMININE|case=NOMINATIVE	
harena	harena	NN	number=SINGULAR|gender=FEMININE|case=NOMINATIVE	
Tagi	Tagus	NN	number=SINGULAR|gender=MASCULINE|case=GENITIVE	
quod	qui	PRON	number=SINGULAR|gender=NEUTER|case=NOMINATIVE	
-que	que	CONJ	_	
in	in	PREP	_	
mare	mare	NN	number=SINGULAR|gender=NEUTER|case=ACCUSATIVE	
volvitur	volvo	VB	person=PERSON_3|number=SINGULAR|tense=PR|mood=INDICATIVE|voice=PASSIVE	
aurum	aurum	NN	number=SINGULAR|gender=NEUTER|case=NOMINATIVE	
ut	ut	CONJ	_	
somno	somnus	NN	number=SINGULAR|gender=MASCULINE|case=ABLATIVE	
careas	careo	VB	person=PERSON_2|number=SINGULAR|tense=PR|mood=SUBJUNCTIVE|voice=ACTIVE	
ponenda	pono	VB	number=PLURAL|mood=GERUNDIVE|gender=NEUTER|case=ACCUSATIVE	
-que	que	CONJ	_	
praemia	praemium	NN	number=PLURAL|gender=NEUTER|case=ACCUSATIVE	
sumas	sumo	VB	person=PERSON_2|number=SINGULAR|tense=PR|mood=SUBJUNCTIVE|voice=ACTIVE	
tristis	tristis	ADJ	number=SINGULAR|gender=MASCULINE|case=NOMINATIVE	
et	et	CONJ	_	
a	ab	PREP	_	
magno	magnus	ADJ	number=SINGULAR|gender=MASCULINE|case=ABLATIVE	
semper	semper	ADV	_	
timearis	timeo	VB	person=PERSON_2|number=SINGULAR|tense=PR|mood=SUBJUNCTIVE|voice=ACTIVE	
amico	amicus	ADJ	number=SINGULAR|gender=MASCULINE|case=ABLATIVE	
Stoicus	Stoicus	ADJ	number=SINGULAR|gender=MASCULINE|case=NOMINATIVE	
occidit	occido	VB	person=PERSON_3|number=SINGULAR|tense=PERF|mood=INDICATIVE|voice=ACTIVE	
Baream	Barea	NN	number=SINGULAR|gender=MASCULINE|case=ACCUSATIVE	
delator	delator	NN	number=SINGULAR|gender=MASCULINE|case=NOMINATIVE	
amicum	amicus	NN	number=SINGULAR|gender=MASCULINE|case=ACCUSATIVE	
discipulum	discipulus	NN	number=SINGULAR|gender=MASCULINE|case=ACCUSATIVE	
-que	que	CONJ	_	
senex	senex	NN	number=SINGULAR|gender=MASCULINE|case=NOMINATIVE	
ripa	ripa	NN	number=SINGULAR|gender=FEMININE|case=ABLATIVE	
nutritus	nutrio	VB	number=SINGULAR|tense=PERF|mood=PARTICIPLE|voice=PASSIVE|gender=MASCULINE|case=NOMINATIVE	
in	in	PREP	_	
illa	ille	PRON	number=SINGULAR|gender=FEMININE|case=ABLATIVE	
ad	ad	PREP	_	
quam	qui	PRON	number=SINGULAR|gender=FEMININE|case=ACCUSATIVE	
Gorgonei	Gorgoneus	ADJ	number=SINGULAR|gender=MASCULINE|case=GENITIVE	
delapsa	delabor	VB	number=SINGULAR|tense=PERF|mood=PARTICIPLE|voice=PASSIVE|gender=FEMININE|case=NOMINATIVE	
est	sum	VB	person=PERSON_3|number=SINGULAR|tense=PR|mood=INDICATIVE|voice=ACTIVE	
pinna	pinna	NN	number=SINGULAR|gender=FEMININE|case=NOMINATIVE	
caballi	caballus	NN	number=SINGULAR|gender=MASCULINE|case=GENITIVE	
horum	hic	PRON	number=PLURAL|gender=MASCULINE|case=GENITIVE	
si	si	CONJ	_	
nihil	nihil	IRREG	number=SINGULAR|gender=NEUTER	
est	sum	VB	person=PERSON_3|number=SINGULAR|tense=PR|mood=INDICATIVE|voice=ACTIVE	
,	unknown		_	
aviam	avia	NN	number=SINGULAR|gender=FEMININE|case=ACCUSATIVE	
resupinat	resupino	VB	person=PERSON_3|number=SINGULAR|tense=PR|mood=INDICATIVE|voice=ACTIVE	
amici	amicus	ADJ	number=SINGULAR|gender=MASCULINE|case=GENITIVE	
.	unknown		_	
vacua	vacuus	ADJ	number=PLURAL|gender=NEUTER|case=ACCUSATIVE	
et	et	CONJ	_	
plana	planus	ADJ	number=PLURAL|gender=NEUTER|case=ACCUSATIVE	
omnia	omnis	ADJ	number=PLURAL|gender=NEUTER|case=ACCUSATIVE	
dicas	dico	VB	person=PERSON_2|number=SINGULAR|tense=PR|mood=SUBJUNCTIVE|voice=ACTIVE	
infra	infra	PREP	_	
ventriculum	ventriculus	NN	number=SINGULAR|gender=MASCULINE|case=ACCUSATIVE	
et	et	CONJ	_	
tenui	tenuis	ADJ	number=SINGULAR|gender=FEMININE|case=ABLATIVE	
distantia	disto	VB	number=PLURAL|tense=PR|mood=PARTICIPLE|gender=NEUTER|case=ACCUSATIVE	
rima	rima	NN	number=SINGULAR|gender=FEMININE|case=ABLATIVE	
motus	motus	NN	number=PLURAL|gender=MASCULINE|case=ACCUSATIVE	
astrorum	astrum	NN	number=PLURAL|gender=NEUTER|case=GENITIVE	
ignoro	ignoro	VB	person=PERSON_1|number=SINGULAR|tense=PR|mood=INDICATIVE|voice=ACTIVE	
hortulus	hortulus	NN	number=SINGULAR|gender=MASCULINE|case=NOMINATIVE	
hic	hic	ADV	_	
puteus	puteus	NN	number=SINGULAR|gender=MASCULINE|case=NOMINATIVE	
-que	que	CONJ	_	
brevis	brevis	ADJ	number=SINGULAR|gender=MASCULINE|case=NOMINATIVE	
ne	ne	ADV	_	
-c	que	CONJ	_	
reste	restis	NN	number=SINGULAR|gender=FEMININE|case=ABLATIVE	
movendus	moveo	VB	number=SINGULAR|mood=GERUNDIVE|gender=MASCULINE|case=NOMINATIVE	
in	in	PREP	_	
tenuis	tenuis	ADJ	number=PLURAL|gender=FEMININE|case=ACCUSATIVE	
plantas	planta	NN	number=PLURAL|gender=FEMININE|case=ACCUSATIVE	
facili	facilis	ADJ	number=SINGULAR|gender=MASCULINE|case=ABLATIVE	
diffunditur	diffundo	VB	person=PERSON_3|number=SINGULAR|tense=PR|mood=INDICATIVE|voice=PASSIVE	
haustu	haustus	NN	number=SINGULAR|gender=MASCULINE|case=ABLATIVE	
.	unknown		_	
eundum	eo	VB	number=SINGULAR|mood=GERUNDIVE|gender=NEUTER|case=NOMINATIVE	
est	sum	VB	person=PERSON_3|number=SINGULAR|tense=PR|mood=INDICATIVE|voice=ACTIVE	
"	unknown		_	
Haut	haud	ADV	_	
facile	facilis	ADJ	number=SINGULAR|gender=NEUTER|case=ACCUSATIVE	
emergunt	emergo	VB	person=PERSON_3|number=PLURAL|tense=PR|mood=INDICATIVE|voice=ACTIVE	
quorum	qui	PRON	number=PLURAL|gender=MASCULINE|case=GENITIVE	
virtutibus	virtus	NN	number=PLURAL|gender=FEMININE|case=DATIVE	
opstat	obsto	VB	person=PERSON_3|number=SINGULAR|voice=ACTIVE	
res	res	NN	number=SINGULAR|gender=FEMININE|case=NOMINATIVE	
angusta	angustus	ADJ	number=SINGULAR|gender=FEMININE|case=NOMINATIVE	
domi	domus	NN	number=SINGULAR|gender=FEMININE|case=LOCATIVE	
sed	sed	CONJ	_	
Romae	Roma	NN	number=SINGULAR|gender=FEMININE|case=LOCATIVE	
durior	durus	ADJ	number=SINGULAR|gender=MASCULINE|case=NOMINATIVE|degree=COMPARATIVE	
illis	illic	PRON	number=PLURAL|gender=MASCULINE|case=DATIVE	
conatus	conatus	NN	number=SINGULAR|gender=MASCULINE|case=NOMINATIVE	
'	unknown		_	
exeat	exeo	VB	person=PERSON_3|number=SINGULAR|tense=PR|mood=SUBJUNCTIVE|voice=ACTIVE	
,	unknown		_	
'	unknown		_	
inquit	inquam	VB	person=PERSON_3|number=SINGULAR|tense=PR|mood=INDICATIVE|voice=ACTIVE	
si	si	CONJ	_	
pudor	pudor	NN	number=SINGULAR|gender=MASCULINE|case=NOMINATIVE	
est	sum	VB	person=PERSON_3|number=SINGULAR|tense=PR|mood=INDICATIVE|voice=ACTIVE	
et	et	CONJ	_	
de	de	PREP	_	
pulvino	pulvinus	NN	number=SINGULAR|gender=MASCULINE|case=ABLATIVE	
surgat	surgo	VB	person=PERSON_3|number=SINGULAR|tense=PR|mood=SUBJUNCTIVE|voice=ACTIVE	
equestri	equester	ADJ	number=SINGULAR|gender=MASCULINE|case=ABLATIVE	
cuius	qui	PRON	number=SINGULAR|gender=MASCULINE|case=GENITIVE	
res	res	NN	number=SINGULAR|gender=FEMININE|case=NOMINATIVE	
legi	lex	NN	number=SINGULAR|gender=FEMININE|case=DATIVE	
non	non	ADV	_	
sufficit	sufficio	VB	person=PERSON_3|number=SINGULAR|tense=PR|mood=INDICATIVE|voice=ACTIVE	
et	et	CONJ	_	
sedeant	sedeo	VB	person=PERSON_3|number=PLURAL|tense=PR|mood=SUBJUNCTIVE|voice=ACTIVE	
hic	hic	ADV	_	
lenonum	leno	NN	number=PLURAL|gender=MASCULINE|case=GENITIVE	
pueri	puer	NN	number=PLURAL|gender=MASCULINE|case=NOMINATIVE	
quocumque	quicumque	PRON	number=SINGULAR|gender=MASCULINE|case=ABLATIVE	
ex	ex	PREP	_	
fornice	fornix	NN	number=SINGULAR|gender=MASCULINE|case=ABLATIVE	
nati	nascor	VB	number=PLURAL|tense=PERF|mood=PARTICIPLE|voice=DEPONENS|gender=MASCULINE|case=NOMINATIVE|degree=POSITIVE	
nil	nihil	NN	number=SINGULAR|gender=NEUTER	
habuit	habeo	VB	person=PERSON_3|number=SINGULAR|tense=PERF|mood=INDICATIVE|voice=ACTIVE	
Codrus	Codrus	NN	number=SINGULAR|gender=MASCULINE|case=NOMINATIVE	
.	unknown		_	
centum	centum	NRL	_	
convivae	conviva	NN	number=PLURAL|gender=FEMININE|case=NOMINATIVE	
,			_	
sequitur	sequor	VB	person=PERSON_3|number=SINGULAR|tense=PR|mood=INDICATIVE|voice=PASSIVE	
sua	Sue	NN	number=SINGULAR|gender=FEMININE|case=NOMINATIVE	
quemque	quisque	PRON	number=SINGULAR|gender=MASCULINE|case=ACCUSATIVE	
culina	culina	NN	number=SINGULAR|gender=FEMININE|case=NOMINATIVE	
da	do	VB	person=PERSON_2|number=SINGULAR|tense=PR|mood=IMPERATIVE|voice=ACTIVE	
testem	testis	NN	number=SINGULAR|gender=MASCULINE|case=ACCUSATIVE	
Romae	Roma	NN	number=SINGULAR|gender=FEMININE|case=LOCATIVE	
tam	tam	ADV	_	
sanctum	sancio	VB	number=SINGULAR|tense=PERF|mood=PARTICIPLE|voice=PASSIVE|gender=MASCULINE|case=ACCUSATIVE	
quam	quam	CONJ	_	
fuit	sum	VB	person=PERSON_3|number=SINGULAR|tense=PERF|mood=INDICATIVE|voice=ACTIVE	
hospes	hospes	NN	number=SINGULAR|gender=MASCULINE|case=NOMINATIVE	
numinis	numen	NN	number=SINGULAR|gender=NEUTER|case=GENITIVE	
Idaei	Idaeus	ADJ	number=SINGULAR|gender=NEUTER|case=GENITIVE	
procedat	procedo	VB	person=PERSON_3|number=SINGULAR|tense=PR|mood=SUBJUNCTIVE|voice=ACTIVE	
vel	vel	CONJ	_	
Numa	Numa	NN	number=SINGULAR|gender=MASCULINE|case=NOMINATIVE	
vel	vel	CONJ	_	
qui	qui	PRON	number=SINGULAR|gender=MASCULINE|case=NOMINATIVE	
servavit	servo	VB	person=PERSON_3|number=SINGULAR|tense=PERF|mood=INDICATIVE|voice=ACTIVE	
trepidam	trepidus	ADJ	number=SINGULAR|gender=FEMININE|case=ACCUSATIVE	
flagranti	flagro	VB	number=SINGULAR|tense=PR|mood=PARTICIPLE|gender=FEMININE|case=ABLATIVE	
ex	ex	PREP	_	
aede	aedes	NN	number=SINGULAR|gender=FEMININE|case=ABLATIVE	
Minervam	Minerva	NN	number=SINGULAR|gender=FEMININE|case=ACCUSATIVE	
mentiri	mentior	VB	tense=PR|mood=INFINITIVE|voice=PASSIVE	
nescio	nescio	VB	person=PERSON_1|number=SINGULAR|tense=PR|mood=INDICATIVE|voice=ACTIVE	
natio	natio	NN	number=SINGULAR|gender=FEMININE|case=NOMINATIVE	
comoeda	comoedus	ADJ	number=SINGULAR|gender=FEMININE|case=NOMINATIVE	
est	sum	VB	person=PERSON_3|number=SINGULAR|tense=PR|mood=INDICATIVE|voice=ACTIVE	
si	si	CONJ	_	
vocat	voco	VB	person=PERSON_3|number=SINGULAR|tense=PR|mood=INDICATIVE|voice=ACTIVE	
officium	officium	NN	number=SINGULAR|gender=NEUTER|case=NOMINATIVE	
turba	turba	NN	number=SINGULAR|gender=FEMININE|case=ABLATIVE	
cedente	cedo	VB	number=SINGULAR|tense=PR|mood=PARTICIPLE|gender=FEMININE|case=ABLATIVE	
vehetur	veho	VB	person=PERSON_3|number=SINGULAR|tense=FUTURE|mood=INDICATIVE|voice=PASSIVE	
dives	dives	ADJ	number=SINGULAR|gender=MASCULINE|case=NOMINATIVE	
et	et	CONJ	_	
ingenti	ingens	ADJ	number=SINGULAR|gender=FEMININE|case=ABLATIVE	
curret	curro	VB	person=PERSON_3|number=SINGULAR|tense=FUTURE|mood=INDICATIVE|voice=ACTIVE	
super	super	PREP	_	
ora	os	NN	number=PLURAL|gender=NEUTER|case=ACCUSATIVE	
Liburna	Liburnus	ADJ	number=SINGULAR|gender=FEMININE|case=ABLATIVE	
atque	atque	CONJ	_	
obiter	obiter	ADV	_	
leget	lego	VB	person=PERSON_3|number=SINGULAR|tense=FUTURE|mood=INDICATIVE|voice=ACTIVE	
aut	aut	CONJ	_	
scribet	scribo	VB	person=PERSON_3|number=SINGULAR|tense=FUTURE|mood=INDICATIVE|voice=ACTIVE	
vel	vel	CONJ	_	
dormiet	dormio	VB	person=PERSON_3|number=SINGULAR|tense=FUTURE|mood=INDICATIVE|voice=ACTIVE	
intus	intus	ADV	_	
stat	sto	VB	person=PERSON_3|number=SINGULAR|tense=PR|mood=INDICATIVE|voice=ACTIVE	
contra	contra	ADV	_	
stari	sto	VB	tense=PR|mood=INFINITIVE|voice=PASSIVE	
-que	que	CONJ	_	
iubet	jubeo	VB	person=PERSON_3|number=SINGULAR|tense=PR|mood=INDICATIVE|voice=ACTIVE	
nam	nam	ADV	_	
mihi	ego	PRON	number=SINGULAR|gender=MASCULINE|case=DATIVE	
commota	commoveo	VB	number=SINGULAR|tense=PERF|mood=PARTICIPLE|voice=PASSIVE|gender=FEMININE|case=ABLATIVE	
iam	jam	ADV	_	
dudum	dudum	ADV	_	
mulio	mulio	NN	number=SINGULAR|gender=MASCULINE|case=NOMINATIVE	
virga	virga	NN	number=SINGULAR|gender=FEMININE|case=ABLATIVE	
adnuit	annuo	VB	person=PERSON_3|number=SINGULAR|tense=PERF|mood=INDICATIVE|voice=ACTIVE	
quid	quis	PRON	number=SINGULAR|gender=NEUTER|case=ACCUSATIVE	
das	do	VB	person=PERSON_2|number=SINGULAR|tense=PR|mood=INDICATIVE|voice=ACTIVE	
ut	ut	CONJ	_	
Cossum	Cossus	NN	number=SINGULAR|gender=MASCULINE|case=ACCUSATIVE	
aliquando	aliquando	ADV	_	
salutes	saluto	VB	person=PERSON_2|number=SINGULAR|tense=PR|mood=SUBJUNCTIVE|voice=ACTIVE	
ut	ut	CONJ	_	
te	tu	PRON	number=SINGULAR|gender=MASCULINE|case=ACCUSATIVE	
respiciat	respicio	VB	person=PERSON_3|number=SINGULAR|tense=PR|mood=SUBJUNCTIVE|voice=ACTIVE	
clauso	claudo	VB	number=SINGULAR|tense=PERF|mood=PARTICIPLE|voice=PASSIVE|gender=NEUTER|case=ABLATIVE	
Veiento	Vejento	NN	number=SINGULAR|gender=MASCULINE|case=NOMINATIVE	
labello	labellum	NN	number=SINGULAR|gender=NEUTER|case=ABLATIVE	
adeo	adeo	ADV	_	
tot	tot	ADV	_	
fata	fatum	NN	number=PLURAL|gender=NEUTER|case=NOMINATIVE	
quot	quot	ADV	_	
illa	ille	PRON	number=SINGULAR|gender=FEMININE|case=ABLATIVE	
nocte	nox	NN	number=SINGULAR|gender=FEMININE|case=ABLATIVE	
patent	pateo	VB	person=PERSON_3|number=PLURAL|tense=PR|mood=INDICATIVE|voice=ACTIVE	
vigiles	vigil	ADJ	number=PLURAL|gender=FEMININE|case=NOMINATIVE	
te	tu	PRON	number=SINGULAR|gender=MASCULINE|case=ABLATIVE	
praetereunte	praetereo	VB	number=SINGULAR|tense=PR|mood=PARTICIPLE|voice=ACTIVE|gender=MASCULINE|case=ABLATIVE	
fenestrae	fenestra	NN	number=PLURAL|gender=FEMININE|case=NOMINATIVE	
protinus	protinus	ADV	_	
ad	ad	PREP	_	
censum	censum	NN	number=SINGULAR|gender=NEUTER|case=ACCUSATIVE	
,			_	
de	de	PREP	_	
moribus	mos	NN	number=PLURAL|gender=MASCULINE|case=ABLATIVE	
ultima	ulter	ADJ	number=SINGULAR|gender=FEMININE|case=NOMINATIVE	
fiet	fio	VB	person=PERSON_3|number=SINGULAR|tense=FUTURE|mood=INDICATIVE|voice=ACTIVE	
quaestio	quaestio	NN	number=SINGULAR|gender=FEMININE|case=NOMINATIVE	
"	unknown		_	
Quid	quis	PRON	number=SINGULAR|gender=NEUTER|case=ACCUSATIVE	
Romae	Roma	NN	number=SINGULAR|gender=FEMININE|case=LOCATIVE	
faciam	facio	VB	person=PERSON_1|number=SINGULAR|tense=PR|mood=SUBJUNCTIVE|voice=ACTIVE	
"	unknown		_	
Quae	qui	PRON	number=SINGULAR|gender=FEMININE|case=NOMINATIVE	
nunc	nunc	ADV	_	
divitibus	dives	NN	number=PLURAL|case=DATIVE	
gens	gens	NN	number=SINGULAR|gender=FEMININE|case=NOMINATIVE	
acceptissima	accipio	ADJ	number=SINGULAR|gender=FEMININE|case=NOMINATIVE|degree=SUPERLATIVE	
nostris	noster	ADJ	number=PLURAL|gender=MASCULINE|case=DATIVE	
et	et	CONJ	_	
quos	quis	NN	number=PLURAL|gender=MASCULINE|case=ACCUSATIVE	
praecipue	praecipuus	ADV	_	
fugiam	fugio	VB	person=PERSON_1|number=SINGULAR|tense=FUTURE|mood=INDICATIVE|voice=ACTIVE	
properabo	propero	VB	person=PERSON_1|number=SINGULAR|tense=FUTURE|mood=INDICATIVE|voice=ACTIVE	
fateri	fateor	VB	tense=PR|mood=INFINITIVE|voice=PASSIVE	
ne	ne	ADV	_	
-c	que	CONJ	_	
pudor	pudor	NN	number=SINGULAR|gender=MASCULINE|case=NOMINATIVE	
opstabit	opsto	VB	person=PERSON_3|number=SINGULAR|tense=FUTURE|mood=INDICATIVE|voice=ACTIVE	
vive	vivo	VB	person=PERSON_2|number=SINGULAR|tense=PR|mood=IMPERATIVE|voice=ACTIVE	
bidentis	bidens	ADJ	number=PLURAL|gender=MASCULINE|case=ACCUSATIVE	
amans	amo	VB	number=SINGULAR|tense=PR|mood=PARTICIPLE|gender=MASCULINE|case=NOMINATIVE	
et	et	CONJ	_	
culti	colo	VB	number=SINGULAR|tense=PERF|mood=PARTICIPLE|voice=PASSIVE|gender=MASCULINE|case=GENITIVE	
vilicus	vilicus	NN	number=SINGULAR|gender=MASCULINE|case=NOMINATIVE	
horti	hortus	NN	number=SINGULAR|gender=MASCULINE|case=GENITIVE	
unde	unde	ADV	_	
epulum	epulum	NN	number=SINGULAR|gender=NEUTER|case=ACCUSATIVE	
possis	possum	VB	person=PERSON_2|number=SINGULAR|tense=PR|mood=SUBJUNCTIVE|voice=ACTIVE	
centum	centum	NRL	_	
dare	do	VB	tense=PR|mood=INFINITIVE|voice=ACTIVE	
Pythagoreis	Pythagoreus	ADJ	number=PLURAL|gender=MASCULINE|case=DATIVE	
non	non	ADV	_	
sumus	sum	VB	person=PERSON_1|number=PLURAL|tense=PR|mood=INDICATIVE|voice=ACTIVE	
ergo	ergo	ADV	_	
pares	par	ADJ	number=PLURAL|gender=MASCULINE|case=NOMINATIVE	
nil	nihil	NN	number=SINGULAR|gender=NEUTER	
habet	habeo	VB	person=PERSON_3|number=SINGULAR|tense=PR|mood=INDICATIVE|voice=ACTIVE	
infelix	infelix	ADJ	number=SINGULAR|gender=FEMININE|case=NOMINATIVE	
paupertas	paupertas	NN	number=SINGULAR|gender=FEMININE|case=NOMINATIVE	
durius	durus	ADJ	number=SINGULAR|gender=NEUTER|case=ACCUSATIVE|degree=COMPARATIVE	
in	in	PREP	_	
se	sui	PRON	number=SINGULAR|gender=FEMININE|case=ABLATIVE	
quam	quam	CONJ	_	
quod	quod	CONJ	_	
ridiculos	ridiculus	ADJ	number=PLURAL|gender=MASCULINE|case=ACCUSATIVE	
homines	homo	NN	number=PLURAL|gender=MASCULINE|case=ACCUSATIVE	
facit	facio	VB	person=PERSON_3|number=SINGULAR|tense=PR|mood=INDICATIVE|voice=ACTIVE	
.	unknown		_	
nam	nam	ADV	_	
-que	que	CONJ	_	
facit	facio	VB	person=PERSON_3|number=SINGULAR|tense=PR|mood=INDICATIVE|voice=ACTIVE	
somnum	somnus	NN	number=SINGULAR|gender=MASCULINE|case=ACCUSATIVE	
clausa	claudo	VB	number=SINGULAR|tense=PERF|mood=PARTICIPLE|voice=PASSIVE|gender=FEMININE|case=ABLATIVE	
lectica	lectica	NN	number=SINGULAR|gender=FEMININE|case=NOMINATIVE	
fenestra	fenestra	NN	number=SINGULAR|gender=FEMININE|case=ABLATIVE	
,	unknown		_	
ante	ante	ADV	_	
tamen	tamen	ADV	_	
veniet	venio	VB	person=PERSON_3|number=SINGULAR|tense=FUTURE|mood=INDICATIVE|voice=ACTIVE	
quam	quam	ADV	_	
multa	multus	ADJ	number=SINGULAR|gender=FEMININE|case=ABLATIVE	
magna	magnus	ADJ	number=SINGULAR|gender=FEMININE|case=ABLATIVE	
-que	que	CONJ	_	
paropside	paropsis	NN	number=SINGULAR|gender=FEMININE|case=ABLATIVE	
cenat	ceno	VB	person=PERSON_3|number=SINGULAR|tense=PR|mood=INDICATIVE|voice=ACTIVE	
?	unknown		_	
'	unknown		_	
nutant	nuto	VB	person=PERSON_3|number=PLURAL|tense=PR|mood=INDICATIVE|voice=ACTIVE	
alte	altus	ADV	_	
populo	populus	NN	number=SINGULAR|gender=MASCULINE|case=DATIVE	
-que	que	CONJ	_	
minantur	minor	VB	person=PERSON_3|number=PLURAL|tense=PR|mood=INDICATIVE|voice=PASSIVE	
me	ego	PRON	number=SINGULAR|gender=MASCULINE|case=ABLATIVE	
prior	prior	ADJ	number=SINGULAR|gender=MASCULINE|case=NOMINATIVE|degree=COMPARATIVE	
ille	ille	PRON	number=SINGULAR|gender=MASCULINE|case=NOMINATIVE	
signabit	signo	VB	person=PERSON_3|number=SINGULAR|tense=FUTURE|mood=INDICATIVE|voice=ACTIVE	
fultus	fulcio	VB	number=SINGULAR|tense=PERF|mood=PARTICIPLE|voice=PASSIVE|gender=MASCULINE|case=NOMINATIVE	
-que	que	CONJ	_	
toro	torus	NN	number=SINGULAR|gender=MASCULINE|case=ABLATIVE	
meliore	bonus	ADJ	number=SINGULAR|gender=MASCULINE|case=ABLATIVE|degree=COMPARATIVE	
recumbet	recumbo	VB	number=SINGULAR|tense=FUTURE|voice=ACTIVE	
,	comma	CONJ	_	
advectus	adveho	VB	number=SINGULAR|tense=PERF|mood=PARTICIPLE|voice=PASSIVE|gender=MASCULINE|case=NOMINATIVE	
Romam	Roma	NN	number=SINGULAR|gender=FEMININE|case=ACCUSATIVE	
quo	qui	PRON	number=SINGULAR|gender=MASCULINE|case=ABLATIVE	
pruna	prunum	NN	number=PLURAL|gender=NEUTER|case=NOMINATIVE	
et	et	CONJ	_	
cottona	cottona	NN	number=PLURAL|gender=NEUTER|case=NOMINATIVE	
vento	ventus	NN	number=SINGULAR|gender=MASCULINE|case=ABLATIVE	
clari	clarus	ADJ	number=SINGULAR|gender=MASCULINE|case=GENITIVE	
velamen	velamen	NN	number=SINGULAR|gender=NEUTER|case=ACCUSATIVE	
honoris	honor	NN	number=SINGULAR|gender=MASCULINE|case=GENITIVE	
sufficiunt	sufficio	VB	person=PERSON_3|number=PLURAL|tense=PR|mood=INDICATIVE|voice=ACTIVE	
tunicae	tunica	NN	number=PLURAL|gender=FEMININE|case=NOMINATIVE	
summis	summus	ADJ	number=PLURAL|gender=MASCULINE|case=DATIVE	
aedilibus	aedilis	NN	number=PLURAL|gender=MASCULINE|case=DATIVE	
albae	albus	ADJ	number=PLURAL|gender=FEMININE|case=NOMINATIVE	
.	unknown		_	
"	unknown		_	
Si	si	CONJ	_	
potes	possum	VB	person=PERSON_2|number=SINGULAR|tense=PR|mood=INDICATIVE|voice=ACTIVE	
avelli	avello	VB	tense=PR|mood=INFINITIVE|voice=PASSIVE	
circensibus	circensis	ADJ	number=PLURAL|gender=MASCULINE|case=ABLATIVE	
optima	bonus	ADJ	number=SINGULAR|gender=FEMININE|case=NOMINATIVE	
Sorae	Sora	NN	number=SINGULAR|gender=FEMININE|case=LOCATIVE	
aut	aut	CONJ	_	
Fabrateriae	Fabrateria	NN	number=SINGULAR|gender=FEMININE|case=LOCATIVE	
domus	domus	NN	number=SINGULAR|gender=FEMININE|case=NOMINATIVE	
aut	aut	CONJ	_	
Frusinone	Frusino	NN	number=SINGULAR|gender=FEMININE|case=LOCATIVE	
paratur	paro	VB	person=PERSON_3|number=SINGULAR|tense=PR|mood=INDICATIVE|voice=PASSIVE	
quanti	quantus	ADJ	number=SINGULAR|gender=NEUTER|case=GENITIVE	
nunc	nunc	ADV	_	
tenebras	tenebrae	NN	number=PLURAL|gender=FEMININE|case=ACCUSATIVE	
unum	unus	ADJ	number=SINGULAR|gender=MASCULINE|case=ACCUSATIVE	
conducis	conduco	VB	person=PERSON_2|number=SINGULAR|tense=PR|mood=INDICATIVE|voice=ACTIVE	
in	in	PREP	_	
annum	annus	NN	number=SINGULAR|gender=MASCULINE|case=ACCUSATIVE	
"	unknown		_	
Quod	qui	PRON	number=SINGULAR|gender=NEUTER|case=NOMINATIVE	
porro	porro	ADV	_	
officium	officium	NN	number=SINGULAR|gender=NEUTER|case=NOMINATIVE	
ne	ne	ADV	_	
nobis	nos	PRON	number=PLURAL|gender=MASCULINE|case=DATIVE	
blandiar	blandio	VB	person=PERSON_1|number=SINGULAR|tense=PR|mood=SUBJUNCTIVE|voice=PASSIVE	
aut	aut	CONJ	_	
quod	qui	PRON	number=SINGULAR|gender=NEUTER|case=NOMINATIVE	
pauperis	pauper	NN	number=SINGULAR|gender=MASCULINE|case=GENITIVE	
hic	hic	ADV	_	
meritum	meritum	NN	number=SINGULAR|gender=NEUTER|case=NOMINATIVE	
si	si	CONJ	_	
curet	curo	VB	person=PERSON_3|number=SINGULAR|tense=PR|mood=SUBJUNCTIVE|voice=ACTIVE	
nocte	nox	NN	number=SINGULAR|gender=FEMININE|case=ABLATIVE	
togatus	togatus	NN	number=SINGULAR|gender=MASCULINE|case=NOMINATIVE	
currere	curro	VB	tense=PR|mood=INFINITIVE|voice=ACTIVE	
cum	Cum	CONJ	_	
praetor	praetor	NN	number=SINGULAR|gender=MASCULINE|case=NOMINATIVE	
lictorem	lictor	NN	number=SINGULAR|gender=MASCULINE|case=ACCUSATIVE	
impellat	impello	VB	person=PERSON_3|number=SINGULAR|tense=PR|mood=SUBJUNCTIVE|voice=ACTIVE	
et	et	CONJ	_	
ire	eo	VB	tense=PR|mood=INFINITIVE|voice=ACTIVE	
praecipitem	praeceps	ADJ	number=SINGULAR|gender=MASCULINE|case=ACCUSATIVE	
iubeat	jubeo	VB	person=PERSON_3|number=SINGULAR|tense=PR|mood=SUBJUNCTIVE|voice=ACTIVE	
dudum	dudum	ADV	_	
vigilantibus	vigilo	VB	number=PLURAL|tense=PR|mood=PARTICIPLE|gender=FEMININE|case=ABLATIVE	
orbis	orbus	ADJ	number=PLURAL|gender=FEMININE|case=ABLATIVE	
ne	ne	ADV	_	
prior	prior	ADJ	number=SINGULAR|gender=MASCULINE|case=NOMINATIVE|degree=COMPARATIVE	
Albinam	Albina	NN	number=SINGULAR|gender=MASCULINE|case=ACCUSATIVE	
et	et	CONJ	_	
Modiam	Modia	NN	number=SINGULAR|gender=MASCULINE|case=ACCUSATIVE	
collega	collega	NN	number=SINGULAR|gender=MASCULINE|case=NOMINATIVE	
salutet	saluto	VB	person=PERSON_3|number=SINGULAR|tense=PR|mood=SUBJUNCTIVE|voice=ACTIVE	
melior	bonus	ADJ	number=SINGULAR|gender=MASCULINE|case=NOMINATIVE|degree=COMPARATIVE	
qui	qui	PRON	number=SINGULAR|gender=MASCULINE|case=NOMINATIVE	
semper	semper	ADV	_	
et	et	CONJ	_	
omni	omnis	ADJ	number=SINGULAR|gender=FEMININE|case=ABLATIVE	
nocte	nox	NN	number=SINGULAR|gender=FEMININE|case=ABLATIVE	
die	dies	NN	number=SINGULAR|gender=MASCULINE|case=ABLATIVE	
-que	que	CONJ	_	
potest	possum	VB	person=PERSON_3|number=SINGULAR|tense=PR|mood=INDICATIVE|voice=ACTIVE	
aliena	alienus	ADJ	number=SINGULAR|gender=FEMININE|case=ABLATIVE	
sumere	sumo	VB	tense=PR|mood=INFINITIVE|voice=ACTIVE	
vultum	vultus	NN	number=SINGULAR|gender=MASCULINE|case=ACCUSATIVE	
a	ab	PREP	_	
facie	facies	NN	number=SINGULAR|gender=FEMININE|case=ABLATIVE	
,			_	
iactare	jacto	VB	tense=PR|mood=INFINITIVE|voice=ACTIVE	
manus	manus	NN	number=PLURAL|gender=FEMININE|case=ACCUSATIVE	
,			_	
laudare	laudo	VB	tense=PR|mood=INFINITIVE|voice=ACTIVE	
paratus	paro	VB	number=SINGULAR|tense=PERF|mood=PARTICIPLE|voice=PASSIVE|gender=MASCULINE|case=NOMINATIVE	
si	si	CONJ	_	
bene	bene	ADV	_	
ructavit	ructo	VB	person=PERSON_3|number=SINGULAR|tense=PERF|mood=INDICATIVE|voice=ACTIVE	
,	comma	CONJ	_	
si	si	CONJ	_	
rectum	rectus	ADJ	number=SINGULAR|gender=NEUTER|case=ACCUSATIVE	
minxit	mingo	VB	person=PERSON_3|number=SINGULAR|tense=PERF|mood=INDICATIVE|voice=ACTIVE	
amicus	amicus	NN	number=SINGULAR|gender=MASCULINE|case=NOMINATIVE	
si	si	CONJ	_	
trulla	trulla	NN	number=SINGULAR|gender=FEMININE|case=NOMINATIVE	
inverso	inverto	VB	number=SINGULAR|tense=PERF|mood=PARTICIPLE|voice=PASSIVE|gender=MASCULINE|case=ABLATIVE	
crepitum	crepitus	NN	number=SINGULAR|gender=MASCULINE|case=ACCUSATIVE	
dedit	do	VB	person=PERSON_3|number=SINGULAR|tense=PERF|mood=INDICATIVE|voice=ACTIVE	
aurea	aurea	NN	number=SINGULAR|gender=FEMININE|case=NOMINATIVE	
fundo	fundus	NN	number=SINGULAR|gender=MASCULINE|case=ABLATIVE	
magno	magnus	ADJ	number=SINGULAR|gender=NEUTER|case=ABLATIVE	
hospitium	hospitium	NN	number=SINGULAR|gender=NEUTER|case=NOMINATIVE	
miserabile	miserabilis	ADJ	number=SINGULAR|gender=NEUTER|case=NOMINATIVE	
magno	magnus	ADJ	number=SINGULAR|gender=NEUTER|case=ABLATIVE	
servorum	servus	NN	number=PLURAL|gender=MASCULINE|case=GENITIVE	
ventres	venter	NN	number=PLURAL|gender=MASCULINE|case=NOMINATIVE	
et	et	CONJ	_	
frugi	frugi	ADJ	number=SINGULAR|gender=FEMININE|case=NOMINATIVE	
cenula	cenula	NN	number=SINGULAR|gender=FEMININE|case=NOMINATIVE	
magno	magnus	ADJ	number=SINGULAR|gender=NEUTER|case=ABLATIVE	
.	unknown		_	
Sed	sed	CONJ	_	
dum	dum	CONJ	_	
tota	totus	ADJ	number=SINGULAR|gender=FEMININE|case=NOMINATIVE	
domus	domus	NN	number=SINGULAR|gender=FEMININE|case=NOMINATIVE	
raeda	raeda	NN	number=SINGULAR|gender=FEMININE|case=ABLATIVE	
componitur	compono	VB	person=PERSON_3|number=SINGULAR|tense=PR|mood=INDICATIVE|voice=PASSIVE	
una	unus	ADJ	number=SINGULAR|gender=FEMININE|case=ABLATIVE	
substitit	substo	VB	person=PERSON_3|number=SINGULAR|tense=PERF|voice=ACTIVE	
ad	ad	PREP	_	
veteres	vetus	ADJ	number=PLURAL|gender=MASCULINE|case=ACCUSATIVE	
arcus	arcus	NN	number=PLURAL|gender=MASCULINE|case=ACCUSATIVE	
madidam	madidus	ADJ	number=SINGULAR|gender=FEMININE|case=ACCUSATIVE	
-que	que	CONJ	_	
Capenam	Capena	NN	number=SINGULAR|gender=FEMININE|case=ACCUSATIVE	
,	unknown		_	
hic	hic	ADV	_	
ubi	ubi	CONJ	_	
nocturnae	nocturnus	ADJ	number=SINGULAR|gender=FEMININE|case=DATIVE	
Numa	Numa	NN	number=SINGULAR|gender=MASCULINE|case=NOMINATIVE	
constituebat	constituo	VB	person=PERSON_3|number=SINGULAR|tense=IMP|mood=INDICATIVE|voice=ACTIVE	
amicae	amica	NN	number=SINGULAR|gender=FEMININE|case=DATIVE	
nunc	nunc	ADV	_	
sacri	sacer	ADJ	number=SINGULAR|gender=MASCULINE|case=GENITIVE	
fontis	fons	NN	number=SINGULAR|gender=MASCULINE|case=GENITIVE	
nemus	nemus	NN	number=SINGULAR|gender=NEUTER|case=NOMINATIVE	
et	et	CONJ	_	
delubra	delubrum	NN	number=PLURAL|gender=NEUTER|case=NOMINATIVE	
locantur	loco	VB	person=PERSON_3|number=PLURAL|tense=PR|mood=INDICATIVE|voice=PASSIVE	
Iudaeis	Iudaeus	NN	number=PLURAL|gender=MASCULINE|case=DATIVE	
quorum	qui	PRON	number=PLURAL|gender=MASCULINE|case=GENITIVE	
cophinus	cophinus	NN	number=SINGULAR|gender=MASCULINE|case=NOMINATIVE	
faenum	faenum	NN	number=SINGULAR|gender=NEUTER|case=NOMINATIVE	
-que	que	CONJ	_	
supellex	supellex	NN	number=SINGULAR|gender=FEMININE|case=NOMINATIVE	
praestare	praesto	VB	tense=PR|mood=INFINITIVE|voice=ACTIVE	
tributa	tributum	NN	number=PLURAL|gender=NEUTER|case=ACCUSATIVE	
clientes	cliens	NN	number=PLURAL|gender=MASCULINE|case=NOMINATIVE	
cogimur	cogo	VB	person=PERSON_1|number=PLURAL|tense=PR|mood=INDICATIVE|voice=PASSIVE	
et	et	CONJ	_	
cultis	colo	VB	number=PLURAL|tense=PERF|mood=PARTICIPLE|voice=PASSIVE|gender=MASCULINE|case=DATIVE	
augere	augeo	VB	tense=PR|mood=INFINITIVE|voice=ACTIVE	
peculia	peculium	NN	number=PLURAL|gender=NEUTER|case=ACCUSATIVE	
servis	servus	NN	number=PLURAL|gender=MASCULINE|case=DATIVE	
ille	ille	PRON	number=SINGULAR|gender=MASCULINE|case=NOMINATIVE	
metit	meto	VB	person=PERSON_3|number=SINGULAR|tense=PR|mood=INDICATIVE|voice=ACTIVE	
barbam	barba	NN	number=SINGULAR|gender=FEMININE|case=ACCUSATIVE	
,	comma	CONJ	_	
crinem	crinis	NN	number=SINGULAR|gender=MASCULINE|case=ACCUSATIVE	
hic	hic	PRON	number=SINGULAR|gender=MASCULINE|case=NOMINATIVE	
deponit	depono	VB	person=PERSON_3|number=SINGULAR|tense=PR|mood=INDICATIVE|voice=ACTIVE	
amati	amo	VB	number=SINGULAR|tense=PERF|mood=PARTICIPLE|voice=PASSIVE|gender=MASCULINE|case=GENITIVE	
ergo	ergo	ADV	_	
vale	valeo	VB	person=PERSON_2|number=SINGULAR|tense=PR|mood=IMPERATIVE|voice=ACTIVE	
nostri	nos	PRON	number=PLURAL|gender=MASCULINE|case=GENITIVE	
memor	memor	ADJ	number=SINGULAR|gender=MASCULINE|case=NOMINATIVE	
et	et	CONJ	_	
quotiens	quotiens	ADV	_	
te	tu	PRON	number=SINGULAR|gender=MASCULINE|case=ACCUSATIVE	
Roma	Roma	NN	number=SINGULAR|gender=FEMININE|case=NOMINATIVE	
tuo	tuus	ADJ	number=SINGULAR|gender=NEUTER|case=DATIVE	
refici	reficio	VB	tense=PR|mood=INFINITIVE|voice=PASSIVE	
properantem	propero	VB	number=SINGULAR|tense=PR|mood=PARTICIPLE|gender=MASCULINE|case=ACCUSATIVE	
reddet	reddo	VB	person=PERSON_3|number=SINGULAR|tense=FUTURE|mood=INDICATIVE|voice=ACTIVE	
Aquino	Aquinum	NN	number=SINGULAR|gender=NEUTER|case=DATIVE	
me	ego	PRON	number=SINGULAR|gender=MASCULINE|case=ACCUSATIVE	
quoque	quoque	ADV	_	
ad	ad	PREP	_	
Helvinam	Helvinus	ADJ	number=SINGULAR|gender=FEMININE|case=ACCUSATIVE	
Cererem	Ceres	NN	number=SINGULAR|gender=FEMININE|case=ACCUSATIVE	
vestram	vester	ADJ	number=SINGULAR|gender=FEMININE|case=ACCUSATIVE	
-que	que	CONJ	_	
Dianam	Diana	NN	number=SINGULAR|gender=FEMININE|case=ACCUSATIVE	
converte	converto	VB	person=PERSON_2|number=SINGULAR|tense=PR|mood=IMPERATIVE|voice=ACTIVE	
a	ab	PREP	_	
Cumis	Cumae	NN	number=PLURAL|gender=FEMININE|case=ABLATIVE	
.	unknown		_	
ite	eo	VB	person=PERSON_2|number=PLURAL|tense=PR|mood=IMPERATIVE|voice=ACTIVE	
quibus	qui	PRON	number=PLURAL|gender=MASCULINE|case=DATIVE	
grata	gratus	ADJ	number=SINGULAR|gender=FEMININE|case=NOMINATIVE	
est	sum	VB	person=PERSON_3|number=SINGULAR|tense=PR|mood=INDICATIVE|voice=ACTIVE	
picta	pingo	VB	number=SINGULAR|tense=PERF|mood=PARTICIPLE|voice=PASSIVE|gender=FEMININE|case=ABLATIVE	
lupa	lupa	NN	number=SINGULAR|gender=FEMININE|case=NOMINATIVE	
barbara	barbarus	ADJ	number=SINGULAR|gender=FEMININE|case=NOMINATIVE	
mitra	mitra	NN	number=SINGULAR|gender=FEMININE|case=ABLATIVE	
!	unknown		_	
omnia	omnis	ADJ	number=PLURAL|gender=NEUTER|case=NOMINATIVE	
Romae	Roma	NN	number=SINGULAR|gender=FEMININE|case=LOCATIVE	
cum	cum	PREP	_	
pretio	pretium	NN	number=SINGULAR|gender=NEUTER|case=ABLATIVE	
.	unknown		_	
libertas	libertas	NN	number=SINGULAR|gender=FEMININE|case=NOMINATIVE	
pauperis	pauper	NN	number=SINGULAR|gender=MASCULINE|case=GENITIVE	
haec	hic	PRON	number=SINGULAR|gender=FEMININE|case=NOMINATIVE	
est	sum	VB	person=PERSON_3|number=SINGULAR|tense=PR|mood=INDICATIVE|voice=ACTIVE	
pulsatus	pulso	VB	number=SINGULAR|tense=PERF|mood=PARTICIPLE|voice=PASSIVE|gender=MASCULINE|case=NOMINATIVE	
rogat	rogo	VB	person=PERSON_3|number=SINGULAR|tense=PR|mood=INDICATIVE|voice=ACTIVE	
et	et	CONJ	_	
pugnis	pugnus	NN	number=PLURAL|gender=MASCULINE|case=ABLATIVE	
concisus	concido	VB	number=SINGULAR|tense=PERF|mood=PARTICIPLE|voice=PASSIVE|gender=MASCULINE|case=NOMINATIVE	
adorat	adoro	VB	person=PERSON_3|number=SINGULAR|tense=PR|mood=INDICATIVE|voice=ACTIVE	
ut	ut	CONJ	_	
liceat	liceo	VB	person=PERSON_3|number=SINGULAR|tense=PR|mood=SUBJUNCTIVE|voice=ACTIVE	
paucis	paucus	ADJ	number=PLURAL|gender=MASCULINE|case=ABLATIVE	
cum	Cum	CONJ	_	
dentibus	dens	NN	number=PLURAL|gender=MASCULINE|case=ABLATIVE	
inde	inde	ADV	_	
reverti	revorto	VB	tense=PR|mood=INFINITIVE|voice=PASSIVE	
divitis	dives	NN	number=SINGULAR|case=GENITIVE	
hic	hic	ADV	_	
servo	servus	ADJ	number=SINGULAR|gender=MASCULINE|case=DATIVE	
claudit	claudo	VB	person=PERSON_3|number=SINGULAR|tense=PR|mood=INDICATIVE|voice=ACTIVE	
latus	latus	NN	number=SINGULAR|gender=NEUTER|case=ACCUSATIVE	
ingenuorum	ingenuus	ADJ	number=PLURAL|gender=MASCULINE|case=GENITIVE	
filius	filius	NN	number=SINGULAR|gender=MASCULINE|case=NOMINATIVE	
hic	hic	PRON	number=SINGULAR|gender=MASCULINE|case=NOMINATIVE	
alta	altus	ADJ	number=SINGULAR|gender=FEMININE|case=ABLATIVE	
Sicyone	Sicyon	NN	number=SINGULAR|gender=FEMININE|case=ABLATIVE	
ast	at	CONJ	_	
hic	hic	PRON	number=SINGULAR|gender=MASCULINE|case=NOMINATIVE	
Amydone	Amydon	NN	number=SINGULAR|gender=FEMININE|case=ABLATIVE	
relicta	relinquo	VB	number=SINGULAR|tense=PERF|mood=PARTICIPLE|voice=PASSIVE|gender=FEMININE|case=ABLATIVE	
hic	hic	PRON	number=SINGULAR|gender=MASCULINE|case=NOMINATIVE	
Andro	Andros	NN	number=SINGULAR|gender=FEMININE|case=ABLATIVE	
ille	ille	PRON	number=SINGULAR|gender=MASCULINE|case=NOMINATIVE	
Samo	Samos	NN	number=SINGULAR|gender=FEMININE|case=ABLATIVE	
hic	hic	PRON	number=SINGULAR|gender=MASCULINE|case=NOMINATIVE	
Trallibus	Tralles	NN	number=PLURAL|gender=FEMININE|case=ABLATIVE	
aut	aut	CONJ	_	
Alabandis	Alabanda	NN	number=PLURAL|gender=FEMININE|case=ABLATIVE	
Esquilias	Esquiliae	NN	number=PLURAL|gender=FEMININE|case=ACCUSATIVE	
dictum	dico	VB	number=SINGULAR|tense=PERF|mood=PARTICIPLE|voice=PASSIVE|gender=MASCULINE|case=ACCUSATIVE	
-que	que	CONJ	_	
petunt	peto	VB	person=PERSON_3|number=PLURAL|tense=PR|mood=INDICATIVE|voice=ACTIVE	
a	ab	PREP	_	
vimine	vimen	NN	number=SINGULAR|gender=NEUTER|case=ABLATIVE	
collem	collis	NN	number=SINGULAR|gender=MASCULINE|case=ACCUSATIVE	
viscera	viscera	NN	number=PLURAL|gender=NEUTER|case=ACCUSATIVE	
magnarum	magnus	ADJ	number=PLURAL|gender=FEMININE|case=GENITIVE	
domuum	domus	NN	number=PLURAL|gender=FEMININE|case=GENITIVE	
domini	dominus	NN	number=PLURAL|gender=MASCULINE|case=NOMINATIVE	
-que	que	CONJ	_	
futuri	sum	VB	number=PLURAL|tense=FUTURE|mood=PARTICIPLE|voice=ACTIVE|gender=MASCULINE|case=NOMINATIVE	
,	unknown		_	
ingenium	ingenium	NN	number=SINGULAR|gender=NEUTER|case=NOMINATIVE	
velox	velox	ADJ	number=SINGULAR|gender=NEUTER|case=NOMINATIVE	
,	unknown		_	
audacia	audacia	NN	number=SINGULAR|gender=FEMININE|case=NOMINATIVE	
perdita	perdo	VB	number=SINGULAR|tense=PERF|mood=PARTICIPLE|voice=PASSIVE|gender=FEMININE|case=NOMINATIVE	
,	unknown		_	
sermo	sermo	NN	number=SINGULAR|gender=MASCULINE|case=NOMINATIVE	
promptus	promptus	ADJ	number=SINGULAR|gender=MASCULINE|case=NOMINATIVE	
et	et	CONJ	_	
Isaeo	Isaeus	NN	number=SINGULAR|gender=MASCULINE|case=ABLATIVE	
torrentior	torreo	VB	number=SINGULAR|gender=MASCULINE|case=NOMINATIVE|degree=COMPARATIVE	
ede	edo	VB	person=PERSON_2|number=SINGULAR|tense=PR|mood=IMPERATIVE|voice=ACTIVE	
quid	quis	PRON	number=SINGULAR|gender=NEUTER|case=ACCUSATIVE	
illum	ille	PRON	number=SINGULAR|gender=MASCULINE|case=ACCUSATIVE	
esse	sum	VB	tense=PR|mood=INFINITIVE|voice=ACTIVE	
putes	puto	VB	person=PERSON_2|number=SINGULAR|tense=PR|mood=SUBJUNCTIVE|voice=ACTIVE	
nusquam	nusquam	ADV	_	
minor	parvus	ADJ	number=SINGULAR|gender=FEMININE|case=NOMINATIVE|degree=COMPARATIVE	
est	sum	VB	person=PERSON_3|number=SINGULAR|tense=PR|mood=INDICATIVE|voice=ACTIVE	
iactura	jactura	NN	number=SINGULAR|gender=FEMININE|case=NOMINATIVE	
clientis	cliens	NN	number=SINGULAR|gender=MASCULINE|case=GENITIVE	
inde	inde	ADV	_	
reversi	reverto	VB	number=PLURAL|tense=PERF|mood=PARTICIPLE|voice=PASSIVE|gender=MASCULINE|case=NOMINATIVE	
conducunt	conduco	VB	person=PERSON_3|number=PLURAL|tense=PR|mood=INDICATIVE|voice=ACTIVE	
foricas	forica	NN	number=PLURAL|gender=FEMININE|case=ACCUSATIVE	
et	et	CONJ	_	
cur	cur	ADV	_	
non	non	ADV	_	
omnia	omnis	ADJ	number=PLURAL|gender=NEUTER|case=ACCUSATIVE	
cum	Cum	CONJ	_	
sint	sum	VB	person=PERSON_3|number=PLURAL|tense=PR|mood=SUBJUNCTIVE|voice=ACTIVE	
quales	qualis	ADJ	number=PLURAL|gender=MASCULINE|case=ACCUSATIVE	
ex	ex	PREP	_	
humili	humilis	ADJ	number=SINGULAR|gender=NEUTER|case=ABLATIVE	
magna	magnus	ADJ	number=PLURAL|gender=NEUTER|case=ACCUSATIVE	
ad	ad	PREP	_	
fastigia	fastigium	NN	number=PLURAL|gender=NEUTER|case=ACCUSATIVE	
rerum	res	NN	number=PLURAL|gender=FEMININE|case=GENITIVE	
extollit	extollo	VB	person=PERSON_3|number=SINGULAR|tense=PR|mood=INDICATIVE|voice=ACTIVE	
quotiens	quotiens	ADV	_	
voluit	volo	VB	person=PERSON_3|number=SINGULAR|tense=PERF|mood=INDICATIVE|voice=ACTIVE	
Fortuna	fortuna	NN	number=SINGULAR|gender=FEMININE|case=NOMINATIVE	
iocari	jocor	VB	tense=PR|mood=INFINITIVE|voice=PASSIVE	
in	in	PREP	_	
summa	summa	NN	number=SINGULAR|gender=FEMININE|case=ABLATIVE	
non	non	ADV	_	
Maurus	Maurus	NN	number=SINGULAR|gender=MASCULINE|case=NOMINATIVE	
erat	sum	VB	person=PERSON_3|number=SINGULAR|tense=IMP|mood=INDICATIVE|voice=ACTIVE	
ne	ne	ADV	_	
-que	que	CONJ	_	
Sarmata	Sarmata	NN	number=SINGULAR|gender=MASCULINE|case=NOMINATIVE	
ne	ne	ADV	_	
-c	que	CONJ	_	
Thrax	Thrax	NN	number=SINGULAR|gender=MASCULINE|case=NOMINATIVE	
qui	qui	PRON	number=SINGULAR|gender=MASCULINE|case=NOMINATIVE	
sumpsit	sumo	VB	person=PERSON_3|number=SINGULAR|tense=PERF|mood=INDICATIVE|voice=ACTIVE	
pinnas	pinna	NN	number=PLURAL|gender=FEMININE|case=ACCUSATIVE	
mediis	medius	ADJ	number=PLURAL|gender=FEMININE|case=ABLATIVE	
sed	sed	CONJ	_	
natus	nascor	VB	number=SINGULAR|tense=PERF|mood=PARTICIPLE|voice=DEPONENS|gender=MASCULINE|case=NOMINATIVE|degree=POSITIVE	
Athenis	Athenae	NN	number=PLURAL|gender=FEMININE|case=ABLATIVE	
possis	possum	VB	person=PERSON_2|number=SINGULAR|tense=PR|mood=SUBJUNCTIVE|voice=ACTIVE	
ignavus	ignavus	ADJ	number=SINGULAR|gender=MASCULINE|case=NOMINATIVE	
haberi	habeo	VB	tense=PR|mood=INFINITIVE|voice=PASSIVE	
et	et	CONJ	_	
subiti	subitus	ADJ	number=SINGULAR|gender=MASCULINE|case=GENITIVE	
casus	casus	NN	number=SINGULAR|gender=MASCULINE|case=GENITIVE	
inprovidus	improvidus	ADJ	number=SINGULAR|gender=MASCULINE|case=NOMINATIVE	
ad	ad	PREP	_	
cenam	cena	NN	number=SINGULAR|gender=FEMININE|case=ACCUSATIVE	
si	si	CONJ	_	
intestatus	intestatus	ADJ	number=SINGULAR|gender=MASCULINE|case=NOMINATIVE	
eas	eo	VB	person=PERSON_2|number=SINGULAR|tense=PR|mood=SUBJUNCTIVE|voice=ACTIVE	
nil	nihil	IRREG	number=SINGULAR|gender=NEUTER	
mihi	ego	PRON	number=SINGULAR|gender=MASCULINE|case=DATIVE	
respondes	respondeo	VB	person=PERSON_2|number=SINGULAR|tense=PR|mood=INDICATIVE|voice=ACTIVE	
tum	tum	ADV	_	
gemimus	gemo	VB	person=PERSON_1|number=PLURAL|tense=PR|mood=INDICATIVE|voice=ACTIVE	
casus	casus	NN	number=PLURAL|gender=MASCULINE|case=ACCUSATIVE	
urbis	urbs	NN	number=SINGULAR|gender=FEMININE|case=GENITIVE	
,			_	
tunc	tunc	ADV	_	
odimus	odi	VB	person=PERSON_1|number=PLURAL|tense=PERF|mood=INDICATIVE|voice=ACTIVE	
ignem	ignis	NN	number=SINGULAR|gender=MASCULINE|case=ACCUSATIVE	
.	unknown		_	
sic	sic	ADV	_	
libitum	libet	VB	number=SINGULAR|tense=PERF|mood=PARTICIPLE|voice=PASSIVE|gender=NEUTER|case=NOMINATIVE	
vano	vanus	ADJ	number=SINGULAR|gender=MASCULINE|case=DATIVE	
qui	qui	PRON	number=SINGULAR|gender=MASCULINE|case=NOMINATIVE	
nos	nos	PRON	number=PLURAL|gender=MASCULINE|case=ACCUSATIVE	
distinxit	distinguo	VB	person=PERSON_3|number=SINGULAR|tense=PERF|mood=INDICATIVE|voice=ACTIVE	
Othoni	Otho	NN	number=SINGULAR|gender=MASCULINE|case=DATIVE	
dicere	dico	VB	tense=PR|mood=INFINITIVE|voice=ACTIVE	
si	si	CONJ	_	
temptes	tento	VB	person=PERSON_2|number=SINGULAR|tense=PR|mood=SUBJUNCTIVE|voice=ACTIVE	
aliquid	aliquis	PRON	number=SINGULAR|gender=NEUTER|case=ACCUSATIVE	
tacitus	taceo	VB	number=SINGULAR|tense=PERF|mood=PARTICIPLE|voice=PASSIVE|gender=MASCULINE|case=NOMINATIVE	
-ve	ve	CONJ	_	
recedas	recedo	VB	person=PERSON_2|number=SINGULAR|tense=PR|mood=SUBJUNCTIVE|voice=ACTIVE	
tantumdem	tantusdem	ADJ	number=SINGULAR|gender=NEUTER|case=NOMINATIVE	
est	sum	VB	person=PERSON_3|number=SINGULAR|tense=PR|mood=INDICATIVE|voice=ACTIVE	
feriunt	ferio	VB	person=PERSON_3|number=PLURAL|tense=PR|mood=INDICATIVE|voice=ACTIVE	
pariter	pariter	ADV	_	
,			_	
vadimonia	vadimonium	NN	number=PLURAL|gender=NEUTER|case=ACCUSATIVE	
deinde	deinde	ADV	_	
irati	irascor	VB	number=PLURAL|tense=PERF|mood=PARTICIPLE|voice=PASSIVE|gender=MASCULINE|case=NOMINATIVE	
faciunt	facio	VB	person=PERSON_3|number=PLURAL|tense=PR|mood=INDICATIVE|voice=ACTIVE	
.	unknown		_	
carus	carus	ADJ	number=SINGULAR|gender=MASCULINE|case=NOMINATIVE	
erit	sum	VB	person=PERSON_3|number=SINGULAR|tense=FUTURE|mood=INDICATIVE|voice=ACTIVE	
Verri	Verres	NN	number=SINGULAR|gender=MASCULINE|case=DATIVE	
qui	qui	PRON	number=SINGULAR|gender=MASCULINE|case=NOMINATIVE	
Verrem	Verres	NN	number=SINGULAR|gender=MASCULINE|case=ACCUSATIVE	
tempore	tempus	NN	number=SINGULAR|gender=NEUTER|case=ABLATIVE	
quo	qui	PRON	number=SINGULAR|gender=NEUTER|case=ABLATIVE	
vult	volo	VB	person=PERSON_3|number=SINGULAR|tense=PR|mood=INDICATIVE|voice=ACTIVE	
accusare	accuso	VB	tense=PR|mood=INFINITIVE|voice=ACTIVE	
potest	possum	VB	person=PERSON_3|number=SINGULAR|tense=PR|mood=INDICATIVE|voice=ACTIVE	
.	period		_	
quis	quis	PRON	number=SINGULAR|gender=MASCULINE|case=NOMINATIVE	
gener	gener	NN	number=SINGULAR|gender=MASCULINE|case=NOMINATIVE	
hic	hic	ADV	_	
placuit	placeo	VB	person=PERSON_3|number=SINGULAR|tense=PERF|mood=INDICATIVE|voice=ACTIVE	
censu	census	NN	number=SINGULAR|gender=MASCULINE|case=ABLATIVE	
minor	parvus	ADJ	number=SINGULAR|gender=MASCULINE|case=NOMINATIVE|degree=COMPARATIVE	
atque	atque	CONJ	_	
puellae	puella	NN	number=SINGULAR|gender=FEMININE|case=GENITIVE	
sarcinulis	sarcinula	NN	number=PLURAL|gender=FEMININE|case=DATIVE	
impar	impar	ADJ	number=SINGULAR|gender=MASCULINE|case=NOMINATIVE|degree=POSITIVE	
nam	nam	ADV	_	
cum	Cum	CONJ	_	
facilem	facilis	ADJ	number=SINGULAR|gender=FEMININE|case=ACCUSATIVE	
stillavit	stillo	VB	person=PERSON_3|number=SINGULAR|tense=PERF|mood=INDICATIVE|voice=ACTIVE	
in	in	PREP	_	
aurem	auris	NN	number=SINGULAR|gender=FEMININE|case=ACCUSATIVE	
exiguum	exiguus	ADJ	number=SINGULAR|gender=NEUTER|case=ACCUSATIVE	
de	de	PREP	_	
naturae	natura	NN	number=SINGULAR|gender=FEMININE|case=GENITIVE	
patriae	patria	NN	number=SINGULAR|gender=FEMININE|case=GENITIVE	
-que	que	CONJ	_	
veneno	venenum	NN	number=SINGULAR|gender=NEUTER|case=ABLATIVE	
limine	limen	NN	number=SINGULAR|gender=NEUTER|case=ABLATIVE	
summoveor	summoveo	VB	person=PERSON_1|number=SINGULAR|tense=PR|voice=PASSIVE	
,			_	
perierunt	pereo	VB	person=PERSON_3|number=PLURAL|tense=PERF|mood=INDICATIVE|voice=ACTIVE	
tempora	tempus	NN	number=PLURAL|gender=NEUTER|case=NOMINATIVE	
longi	longus	ADJ	number=SINGULAR|gender=NEUTER|case=GENITIVE	
servitii	servitium	NN	number=SINGULAR|gender=NEUTER|case=GENITIVE	
quibusdam	quidam	PRON	number=PLURAL|gender=MASCULINE|case=DATIVE	
somnum	somnus	NN	number=SINGULAR|gender=MASCULINE|case=ACCUSATIVE	
rixa	rixa	NN	number=SINGULAR|gender=FEMININE|case=NOMINATIVE	
facit	facio	VB	person=PERSON_3|number=SINGULAR|tense=PR|mood=INDICATIVE|voice=ACTIVE	
sed	sed	CONJ	_	
quamvis	quamvis	ADV	_	
improbus	improbus	ADJ	number=SINGULAR|gender=MASCULINE|case=NOMINATIVE	
annis	annus	NN	number=PLURAL|gender=MASCULINE|case=ABLATIVE	
atque	atque	CONJ	_	
mero	merum	NN	number=SINGULAR|gender=NEUTER|case=ABLATIVE	
fervens	ferveo	VB	number=SINGULAR|tense=PR|mood=PARTICIPLE|gender=MASCULINE|case=NOMINATIVE	
cavet	caveo	VB	person=PERSON_3|number=SINGULAR|tense=PR|voice=ACTIVE	
hunc	hic	PRON	number=SINGULAR|gender=MASCULINE|case=ACCUSATIVE	
quem	qui	PRON	number=SINGULAR|gender=MASCULINE|case=ACCUSATIVE	
coccina	coccinus	ADJ	number=SINGULAR|gender=FEMININE|case=NOMINATIVE	
laena	laena	NN	number=SINGULAR|gender=FEMININE|case=NOMINATIVE	
vitari	vito	VB	tense=PR|mood=INFINITIVE|voice=PASSIVE	
iubet	jubeo	VB	person=PERSON_3|number=SINGULAR|tense=PR|mood=INDICATIVE|voice=ACTIVE	
et	et	CONJ	_	
comitum	comes	NN	number=PLURAL|gender=MASCULINE|case=GENITIVE	
longissimus	longus	ADJ	number=SINGULAR|gender=MASCULINE|case=NOMINATIVE|degree=SUPERLATIVE	
ordo	ordo	NN	number=SINGULAR|gender=MASCULINE|case=NOMINATIVE	
,	unknown		_	
multum	multus	ADJ	number=SINGULAR|gender=NEUTER|case=NOMINATIVE	
praeterea	praeterea	ADV	_	
flammarum	flamma	NN	number=PLURAL|gender=FEMININE|case=GENITIVE	
et	et	CONJ	_	
aenea	aeneus	ADJ	number=SINGULAR|gender=FEMININE|case=NOMINATIVE	
lampas	lampas	NN	number=SINGULAR|gender=FEMININE|case=NOMINATIVE	
parere	pareo	VB	tense=PR|mood=INFINITIVE|voice=ACTIVE	
necesse	necesse	ADJ	number=SINGULAR|gender=NEUTER|case=NOMINATIVE	
est	sum	VB	person=PERSON_3|number=SINGULAR|tense=PR|mood=INDICATIVE|voice=ACTIVE	
scinduntur	scindo	VB	person=PERSON_3|number=PLURAL|tense=PR|mood=INDICATIVE|voice=PASSIVE	
tunicae	tunica	NN	number=PLURAL|gender=FEMININE|case=NOMINATIVE	
sartae	sarcio	VB	number=PLURAL|tense=PERF|mood=PARTICIPLE|voice=PASSIVE|gender=FEMININE|case=NOMINATIVE	
modo	modo	ADV	_	
,	unknown		_	
longa	longus	ADJ	number=SINGULAR|gender=FEMININE|case=NOMINATIVE	
coruscat	corusco	VB	person=PERSON_3|number=SINGULAR|tense=PR|mood=INDICATIVE|voice=ACTIVE	
serraco	serracum	NN	number=SINGULAR|gender=NEUTER|case=ABLATIVE	
veniente	venio	VB	number=SINGULAR|tense=PR|mood=PARTICIPLE|gender=NEUTER|case=ABLATIVE	
abies	abies	NN	number=SINGULAR|gender=FEMININE|case=NOMINATIVE	
atque	atque	CONJ	_	
altera	alter	ADJ	number=PLURAL|gender=NEUTER|case=NOMINATIVE	
pinum	pinus	NN	number=SINGULAR|gender=FEMININE|case=ACCUSATIVE	
plaustra	plaustrum	NN	number=PLURAL|gender=NEUTER|case=NOMINATIVE	
vehunt	veho	VB	person=PERSON_3|number=PLURAL|tense=PR|mood=INDICATIVE|voice=ACTIVE	
accipe	accipio	VB	person=PERSON_2|number=SINGULAR|tense=PR|mood=IMPERATIVE|voice=ACTIVE	
,	unknown		_	
et	et	CONJ	_	
istud	iste	PRON	number=SINGULAR|gender=NEUTER|case=ACCUSATIVE	
fermentum	fermentum	NN	number=SINGULAR|gender=NEUTER|case=ACCUSATIVE	
tibi	tu	PRON	number=SINGULAR|gender=MASCULINE|case=DATIVE	
habe	habeo	VB	person=PERSON_2|number=SINGULAR|tense=PR|mood=IMPERATIVE|voice=ACTIVE	
ede	edo	VB	person=PERSON_2|number=SINGULAR|tense=PR|mood=IMPERATIVE|voice=ACTIVE	
ubi	ubi	CONJ	_	
consistas	consisto	VB	person=PERSON_2|number=SINGULAR|tense=PR|mood=SUBJUNCTIVE|voice=ACTIVE	
"	unknown		_	
Quis	quis	PRON	number=SINGULAR|gender=MASCULINE|case=NOMINATIVE	
timet	timeo	VB	person=PERSON_3|number=SINGULAR|tense=PR|mood=INDICATIVE|voice=ACTIVE	
aut	aut	CONJ	_	
timuit	timeo	VB	person=PERSON_3|number=SINGULAR|tense=PERF|mood=INDICATIVE|voice=ACTIVE	
gelida	gelidus	ADJ	number=SINGULAR|gender=FEMININE|case=ABLATIVE	
Praeneste	Praeneste	NN	number=SINGULAR|gender=FEMININE|case=ABLATIVE	
ruinam	ruina	NN	number=SINGULAR|gender=FEMININE|case=ACCUSATIVE	
aut	aut	CONJ	_	
positis	pono	VB	number=PLURAL|tense=PERF|mood=PARTICIPLE|voice=PASSIVE|gender=MASCULINE|case=ABLATIVE	
nemorosa	nemorosus	ADJ	number=PLURAL|gender=NEUTER|case=ACCUSATIVE	
inter	inter	PREP	_	
iuga	jugum	NN	number=PLURAL|gender=NEUTER|case=ACCUSATIVE	
Volsiniis	Volsinii	NN	number=PLURAL|gender=MASCULINE|case=ABLATIVE	
aut	aut	CONJ	_	
simplicibus	simplex	ADJ	number=PLURAL|gender=MASCULINE|case=ABLATIVE	
Gabiis	Gabii	NN	number=PLURAL|gender=MASCULINE|case=ABLATIVE	
aut	aut	CONJ	_	
proni	pronus	ADJ	number=SINGULAR|gender=NEUTER|case=GENITIVE	
Tiburis	Tibur	NN	number=SINGULAR|gender=NEUTER|case=GENITIVE	
arce	arx	NN	number=SINGULAR|gender=FEMININE|case=ABLATIVE	
miserae	miser	ADJ	number=SINGULAR|gender=FEMININE|case=GENITIVE	
cognosce	cognosco	VB	person=PERSON_2|number=SINGULAR|tense=PR|mood=IMPERATIVE|voice=ACTIVE	
prohoemia	prohoemium	NN	number=PLURAL|gender=NEUTER|case=ACCUSATIVE	
rixae	rixa	NN	number=SINGULAR|gender=FEMININE|case=GENITIVE	
si	si	CONJ	_	
rixa	rixa	NN	number=SINGULAR|gender=FEMININE|case=NOMINATIVE	
est	sum	VB	person=PERSON_3|number=SINGULAR|tense=PR|mood=INDICATIVE|voice=ACTIVE	
ubi	ubi	CONJ	_	
tu	tu	PRON	number=SINGULAR|gender=MASCULINE|case=NOMINATIVE	
pulsas	pulso	VB	person=PERSON_2|number=SINGULAR|tense=PR|mood=INDICATIVE|voice=ACTIVE	
,			_	
ego	ego	PRON	number=SINGULAR|gender=MASCULINE|case=NOMINATIVE	
vapulo	vapulo	VB	person=PERSON_1|number=SINGULAR|tense=PR|mood=INDICATIVE|voice=ACTIVE	
tantum	tantus	ADV	_	
.	unknown		_	
usque	usque	ADV	_	
adeo	adeo	ADV	_	
nihil	nihil	NN	number=SINGULAR|gender=NEUTER|case=NOMINATIVE	
est	sum	VB	person=PERSON_3|number=SINGULAR|tense=PR|mood=INDICATIVE|voice=ACTIVE	
quod	quod	CONJ	_	
nostra	noster	ADJ	number=SINGULAR|gender=FEMININE|case=NOMINATIVE	
infantia	infantia	NN	number=SINGULAR|gender=FEMININE|case=NOMINATIVE	
caelum	caelum	NN	number=SINGULAR|gender=NEUTER|case=ACCUSATIVE	
hausit	haurio	VB	person=PERSON_3|number=SINGULAR|tense=PERF|mood=INDICATIVE|voice=ACTIVE	
Aventini	Aventinus	ADJ	number=SINGULAR|gender=MASCULINE|case=GENITIVE	
baca	baca	NN	number=SINGULAR|gender=FEMININE|case=ABLATIVE	
nutrita	nutrio	VB	number=SINGULAR|tense=PERF|mood=PARTICIPLE|voice=PASSIVE|gender=FEMININE|case=NOMINATIVE	
Sabina	Sabinus	ADJ	number=SINGULAR|gender=FEMININE|case=ABLATIVE	
maximus	magnus	ADJ	number=SINGULAR|gender=MASCULINE|case=NOMINATIVE	
in	in	PREP	_	
vinclis	vinclum	NN	number=PLURAL|gender=NEUTER|case=ABLATIVE	
ferri	ferrum	NN	number=SINGULAR|gender=NEUTER|case=GENITIVE	
modus	modus	NN	number=SINGULAR|gender=MASCULINE|case=NOMINATIVE	
ut	ut	CONJ	_	
timeas	timeo	VB	person=PERSON_2|number=SINGULAR|tense=PR|mood=SUBJUNCTIVE|voice=ACTIVE	
ne	ne	CONJ	_	
vomer	vomer	NN	number=SINGULAR|gender=MASCULINE|case=NOMINATIVE	
deficiat	deficio	VB	person=PERSON_3|number=SINGULAR|tense=PR|mood=SUBJUNCTIVE|voice=ACTIVE	
,	comma	CONJ	_	
ne	ne	CONJ	_	
marrae	marra	NN	number=PLURAL|gender=FEMININE|case=NOMINATIVE	
et	et	CONJ	_	
sarcula	sarculum	NN	number=PLURAL|gender=NEUTER|case=NOMINATIVE	
desint	desum	VB	person=PERSON_3|number=PLURAL|tense=PR|mood=SUBJUNCTIVE|voice=ACTIVE	
in	in	PREP	_	
qua	qui	PRON	number=SINGULAR|gender=FEMININE|case=ABLATIVE	
te	tu	PRON	number=SINGULAR|gender=MASCULINE|case=ACCUSATIVE	
quaero	quaero	VB	person=PERSON_1|number=SINGULAR|tense=PR|mood=INDICATIVE|voice=ACTIVE	
proseucha	proseucha	NN	number=SINGULAR|gender=FEMININE|case=ABLATIVE	
?	unknown		_	
'	unknown		_	
plena	plenus	ADJ	number=SINGULAR|gender=FEMININE|case=NOMINATIVE	
domus	domus	NN	number=SINGULAR|gender=FEMININE|case=NOMINATIVE	
libis	libum	NN	number=PLURAL|gender=NEUTER|case=ABLATIVE	
venalibus	venalis	ADJ	number=PLURAL|gender=NEUTER|case=ABLATIVE	
fictilibus	fictilis	ADJ	number=PLURAL|gender=NEUTER|case=ABLATIVE	
cenare	ceno	VB	tense=PR|mood=INFINITIVE|voice=ACTIVE	
pudet	pudeo	VB	person=PERSON_3|number=SINGULAR|tense=PR|mood=INDICATIVE|voice=ACTIVE	
quod	qui	PRON	number=SINGULAR|gender=NEUTER|case=ACCUSATIVE	
turpe	turpis	ADJ	number=SINGULAR|gender=NEUTER|case=ACCUSATIVE	
negabis	nego	VB	person=PERSON_2|number=SINGULAR|tense=FUTURE|mood=INDICATIVE|voice=ACTIVE	
translatus	transfero	VB	number=SINGULAR|tense=PERF|mood=PARTICIPLE|voice=PASSIVE|gender=MASCULINE|case=NOMINATIVE	
subito	subito	ADV	_	
ad	ad	PREP	_	
Marsos	Marsus	ADJ	number=PLURAL|gender=MASCULINE|case=ACCUSATIVE	
mensam	mensa	NN	number=SINGULAR|gender=FEMININE|case=ACCUSATIVE	
-que	que	CONJ	_	
Sabellam	Sabellus	ADJ	number=SINGULAR|gender=FEMININE|case=ACCUSATIVE	
contentus	contineo	VB	number=SINGULAR|tense=PERF|mood=PARTICIPLE|voice=PASSIVE|gender=MASCULINE|case=NOMINATIVE	
-que	que	CONJ	_	
illic	illic	ADV	_	
Veneto	venetus	ADJ	number=SINGULAR|gender=MASCULINE|case=ABLATIVE	
duro	durus	ADJ	number=SINGULAR|gender=MASCULINE|case=ABLATIVE	
-que	que	CONJ	_	
cucullo	cucullus	NN	number=SINGULAR|gender=MASCULINE|case=ABLATIVE	
vivendum	vivo	VB	number=SINGULAR|mood=GERUNDIVE|gender=NEUTER|case=NOMINATIVE	
est	sum	VB	person=PERSON_3|number=SINGULAR|tense=PR|mood=INDICATIVE|voice=ACTIVE	
illic	illic	ADV	_	
ubi	ubi	CONJ	_	
nulla	nullus	ADJ	number=PLURAL|gender=NEUTER|case=NOMINATIVE	
incendia	incendium	NN	number=PLURAL|gender=NEUTER|case=NOMINATIVE	
,	comma	CONJ	_	
nulli	nullus	ADJ	number=PLURAL|gender=MASCULINE|case=NOMINATIVE	
nocte	nox	NN	number=SINGULAR|gender=FEMININE|case=ABLATIVE	
metus	metus	NN	number=PLURAL|gender=MASCULINE|case=NOMINATIVE	
.	unknown		_	
nam	nam	ADV	_	
qui	qui	PRON	number=SINGULAR|gender=MASCULINE|case=NOMINATIVE	
spoliet	spolio	VB	person=PERSON_3|number=SINGULAR|tense=PR|mood=SUBJUNCTIVE|voice=ACTIVE	
te	tu	PRON	number=SINGULAR|gender=MASCULINE|case=ACCUSATIVE	
non	non	ADV	_	
derit	defleo	VB	person=PERSON_3|number=SINGULAR|tense=PERF|mood=SUBJUNCTIVE|voice=ACTIVE	
clausis	claudo	VB	number=PLURAL|tense=PERF|mood=PARTICIPLE|voice=PASSIVE|gender=FEMININE|case=ABLATIVE	
domibus	domus	NN	number=PLURAL|gender=FEMININE|case=ABLATIVE	
postquam	postquam	CONJ	_	
omnis	omnis	ADJ	number=SINGULAR|gender=FEMININE|case=NOMINATIVE	
ubique	ubique	ADV	_	
fixa	figo	VB	number=SINGULAR|tense=PERF|mood=PARTICIPLE|voice=PASSIVE|gender=FEMININE|case=NOMINATIVE	
catenatae	cateno	VB	number=SINGULAR|tense=PERF|mood=PARTICIPLE|voice=PASSIVE|gender=FEMININE|case=GENITIVE	
siluit	sileo	VB	person=PERSON_3|number=SINGULAR|tense=PERF|mood=INDICATIVE|voice=ACTIVE	
compago	compago	NN	number=SINGULAR|gender=FEMININE|case=NOMINATIVE	
tabernae	taberna	NN	number=SINGULAR|gender=FEMININE|case=GENITIVE	
non	non	ADV	_	
possum	possum	VB	person=PERSON_1|number=SINGULAR|tense=PR|mood=INDICATIVE|voice=ACTIVE	
ferre	fero	VB	tense=PR|mood=INFINITIVE|voice=ACTIVE	
Quirites	quirites	NN	number=PLURAL|gender=MASCULINE|case=VOCATIVE	
Graecam	Graecus	ADJ	number=SINGULAR|gender=FEMININE|case=ACCUSATIVE	
urbem	urbs	NN	number=SINGULAR|gender=FEMININE|case=ACCUSATIVE	
an	an	CONJ	_	
melior	bonus	ADJ	number=SINGULAR|gender=MASCULINE|case=NOMINATIVE|degree=COMPARATIVE	
cum	Cum	CONJ	_	
Thaida	Thais	NN	number=SINGULAR|gender=FEMININE|case=ACCUSATIVE	
sustinet	sustineo	VB	person=PERSON_3|number=SINGULAR|tense=PR|mood=INDICATIVE|voice=ACTIVE	
aut	aut	CONJ	_	
cum	Cum	CONJ	_	
uxorem	uxor	NN	number=SINGULAR|gender=FEMININE|case=ACCUSATIVE	
comoedus	comoedus	NN	number=SINGULAR|gender=MASCULINE|case=NOMINATIVE	
agit	ago	VB	person=PERSON_3|number=SINGULAR|tense=PR|mood=INDICATIVE|voice=ACTIVE	
vel	vel	CONJ	_	
Dorida	Doris	NN	number=SINGULAR|gender=FEMININE|case=ACCUSATIVE	
nullo	nullus	ADJ	number=SINGULAR|gender=NEUTER|case=ABLATIVE	
cultam	colo	VB	number=SINGULAR|tense=PERF|mood=PARTICIPLE|voice=PASSIVE|gender=FEMININE|case=ACCUSATIVE	
palliolo	palliolum	NN	number=SINGULAR|gender=NEUTER|case=ABLATIVE	
et	et	CONJ	_	
quoniam	quoniam	CONJ	_	
coepit	coepio	VB	person=PERSON_3|number=SINGULAR|tense=PERF|mood=INDICATIVE|voice=ACTIVE	
Graecorum	Graecus	ADJ	number=PLURAL|gender=MASCULINE|case=GENITIVE	
mentio	mentio	NN	number=SINGULAR|gender=FEMININE|case=NOMINATIVE	
transi	transeo	VB	person=PERSON_2|number=SINGULAR|tense=PR|mood=IMPERATIVE|voice=ACTIVE	
gymnasia	gymnasium	NN	number=PLURAL|gender=NEUTER|case=ACCUSATIVE	
atque	atque	CONJ	_	
audi	audio	VB	person=PERSON_2|number=SINGULAR|tense=PR|mood=IMPERATIVE|voice=ACTIVE	
facinus	facinus	NN	number=SINGULAR|gender=NEUTER|case=ACCUSATIVE	
maioris	magnus	ADJ	number=SINGULAR|gender=FEMININE|case=GENITIVE|degree=COMPARATIVE	
abollae	abolla	NN	number=SINGULAR|gender=FEMININE|case=GENITIVE	
ferit	ferio	VB	person=PERSON_3|number=SINGULAR|tense=PR|mood=INDICATIVE|voice=ACTIVE	
hic	hic	PRON	number=SINGULAR|gender=MASCULINE|case=NOMINATIVE	
cubito	cubitum	NN	number=SINGULAR|gender=NEUTER|case=ABLATIVE	
,			_	
ferit	ferio	VB	person=PERSON_3|number=SINGULAR|tense=PR|mood=INDICATIVE|voice=ACTIVE	
assere	asser	NN	number=SINGULAR|gender=MASCULINE|case=ABLATIVE	
duro	durus	ADJ	number=SINGULAR|gender=MASCULINE|case=ABLATIVE	
alter	alter	ADJ	number=SINGULAR|gender=MASCULINE|case=NOMINATIVE	
at	at	CONJ	_	
hic	hic	PRON	number=SINGULAR|gender=MASCULINE|case=NOMINATIVE	
tignum	tignum	NN	number=SINGULAR|gender=NEUTER|case=ACCUSATIVE	
capiti	caput	NN	number=SINGULAR|gender=NEUTER|case=DATIVE	
incutit	incutio	VB	person=PERSON_3|number=SINGULAR|tense=PR|mood=INDICATIVE|voice=ACTIVE	
,			_	
ille	ille	PRON	number=SINGULAR|gender=MASCULINE|case=NOMINATIVE	
metretam	metreta	NN	number=SINGULAR|gender=FEMININE|case=ACCUSATIVE	
nam	nam	ADV	_	
si	si	CONJ	_	
gradibus	gradus	NN	number=PLURAL|gender=MASCULINE|case=ABLATIVE	
trepidatur	trepido	VB	person=PERSON_3|number=SINGULAR|tense=PR|mood=INDICATIVE|voice=PASSIVE	
ab	ab	PREP	_	
imis	imus	ADJ	number=PLURAL|gender=MASCULINE|case=ABLATIVE	
ultimus	ulter	ADJ	number=SINGULAR|gender=MASCULINE|case=NOMINATIVE	
ardebit	ardeo	VB	person=PERSON_3|number=SINGULAR|tense=FUTURE|mood=INDICATIVE|voice=ACTIVE	
quem	qui	PRON	number=SINGULAR|gender=MASCULINE|case=ACCUSATIVE	
tegula	tegula	NN	number=SINGULAR|gender=FEMININE|case=NOMINATIVE	
sola	solus	ADJ	number=SINGULAR|gender=FEMININE|case=NOMINATIVE	
tuetur	tueor	VB	person=PERSON_3|number=SINGULAR|tense=PR|mood=INDICATIVE|voice=PASSIVE	
a	ab	PREP	_	
pluvia	pluvia	NN	number=SINGULAR|gender=FEMININE|case=ABLATIVE	
molles	mollis	ADJ	number=PLURAL|gender=FEMININE|case=NOMINATIVE	
ubi	ubi	CONJ	_	
reddunt	reddo	VB	person=PERSON_3|number=PLURAL|tense=PR|mood=INDICATIVE|voice=ACTIVE	
ova	ovum	NN	number=PLURAL|gender=NEUTER|case=ACCUSATIVE	
columbae	columba	NN	number=PLURAL|gender=FEMININE|case=NOMINATIVE	
.	unknown		_	
magnis	magnus	ADJ	number=PLURAL|gender=FEMININE|case=ABLATIVE	
opibus	ops	NN	number=PLURAL|gender=FEMININE|case=ABLATIVE	
dormitur	dormio	VB	person=PERSON_3|number=SINGULAR|tense=PR|mood=INDICATIVE|voice=PASSIVE	
in	in	PREP	_	
urbe	urbs	NN	number=SINGULAR|gender=FEMININE|case=ABLATIVE	
ergo	ergo	ADV	_	
non	non	ADV	_	
aliter	aliter	ADV	_	
poterit	possum	VB	person=PERSON_3|number=SINGULAR|tense=FUTURE|mood=INDICATIVE|voice=ACTIVE	
dormire	dormio	VB	tense=PR|mood=INFINITIVE|voice=ACTIVE	
scire	scio	VB	tense=PR|mood=INFINITIVE|voice=ACTIVE	
volunt	volo	VB	person=PERSON_3|number=PLURAL|tense=PR|mood=INDICATIVE|voice=ACTIVE	
secreta	secretum	NN	number=PLURAL|gender=NEUTER|case=ACCUSATIVE	
domus	domus	NN	number=SINGULAR|gender=FEMININE|case=GENITIVE	
atque	atque	CONJ	_	
inde	inde	ADV	_	
timeri	timeo	VB	tense=PR|mood=INFINITIVE|voice=PASSIVE	
.	unknown		_	
ipsa	ipse	ADJ	number=SINGULAR|gender=FEMININE|case=NOMINATIVE	
dierum	dies	NN	number=PLURAL|gender=FEMININE|case=GENITIVE	
festorum	festus	ADJ	number=PLURAL|gender=MASCULINE|case=GENITIVE	
herboso	herbosus	ADJ	number=SINGULAR|gender=NEUTER|case=ABLATIVE	
colitur	colo	VB	person=PERSON_3|number=SINGULAR|tense=PR|mood=INDICATIVE|voice=PASSIVE	
si	si	CONJ	_	
quando	quando	ADV	_	
theatro	theatrum	NN	number=SINGULAR|gender=NEUTER|case=ABLATIVE	
maiestas	majestas	NN	number=SINGULAR|gender=FEMININE|case=NOMINATIVE	
tandem	tandem	ADV	_	
-que	que	CONJ	_	
redit	redeo	VB	person=PERSON_3|number=SINGULAR|tense=PERF|mood=INDICATIVE|voice=ACTIVE	
ad	ad	PREP	_	
pulpita	pulpitum	NN	number=PLURAL|gender=NEUTER|case=ACCUSATIVE	
notum	notus	ADJ	number=SINGULAR|gender=NEUTER|case=NOMINATIVE	
exodium	exodium	NN	number=SINGULAR|gender=NEUTER|case=NOMINATIVE	
cum	Cum	CONJ	_	
personae	persona	NN	number=SINGULAR|gender=FEMININE|case=GENITIVE	
pallentis	palleo	VB	number=SINGULAR|tense=PR|mood=PARTICIPLE|gender=FEMININE|case=GENITIVE	
hiatum	hiatus	NN	number=SINGULAR|gender=MASCULINE|case=ACCUSATIVE	
in	in	PREP	_	
gremio	gremium	NN	number=SINGULAR|gender=NEUTER|case=ABLATIVE	
matris	mater	NN	number=SINGULAR|gender=FEMININE|case=GENITIVE	
formidat	formido	VB	person=PERSON_3|number=SINGULAR|tense=PR|mood=INDICATIVE|voice=ACTIVE	
rusticus	rusticus	ADJ	number=SINGULAR|gender=MASCULINE|case=NOMINATIVE	
infans	infans	ADJ	number=SINGULAR|gender=MASCULINE|case=NOMINATIVE|degree=POSITIVE	
aequales	aequalis	ADJ	number=PLURAL|gender=MASCULINE|case=NOMINATIVE	
habitus	habitus	NN	number=PLURAL|gender=MASCULINE|case=NOMINATIVE	
illic	illic	ADV	_	
similes	similis	ADJ	number=PLURAL|gender=MASCULINE|case=ACCUSATIVE	
-que	que	CONJ	_	
videbis	video	VB	person=PERSON_2|number=SINGULAR|tense=FUTURE|mood=INDICATIVE|voice=ACTIVE	
orchestram	orchestra	NN	number=SINGULAR|gender=FEMININE|case=ACCUSATIVE	
et	et	CONJ	_	
populum	populus	NN	number=SINGULAR|gender=MASCULINE|case=ACCUSATIVE	
.	unknown		_	
haec	hic	ADJ	number=PLURAL|gender=NEUTER|case=NOMINATIVE	
inter	inter	PREP	_	
pueros	puer	NN	number=PLURAL|gender=MASCULINE|case=ACCUSATIVE	
varie	varius	ADV	_	
properantur	propero	VB	person=PERSON_3|number=PLURAL|tense=PR|mood=INDICATIVE|voice=PASSIVE	
at	at	CONJ	_	
ille	ille	PRON	number=SINGULAR|gender=MASCULINE|case=NOMINATIVE	
iam	jam	ADV	_	
sedet	sedeo	VB	person=PERSON_3|number=SINGULAR|tense=PR|mood=INDICATIVE|voice=ACTIVE	
in	in	PREP	_	
ripa	ripa	NN	number=SINGULAR|gender=FEMININE|case=ABLATIVE	
taetrum	taeter	ADJ	number=SINGULAR|gender=MASCULINE|case=ACCUSATIVE	
-que	que	CONJ	_	
novicius	novicius	ADJ	number=SINGULAR|gender=MASCULINE|case=NOMINATIVE	
horret	horreo	VB	person=PERSON_3|number=SINGULAR|tense=PR|mood=INDICATIVE|voice=ACTIVE	
porthmea	porthmeus	NN	number=SINGULAR|gender=MASCULINE|case=ACCUSATIVE	
ne	ne	ADV	_	
-c	que	CONJ	_	
sperat	spero	VB	person=PERSON_3|number=SINGULAR|tense=PR|mood=INDICATIVE|voice=ACTIVE	
caenosi	caenosus	ADJ	number=SINGULAR|gender=MASCULINE|case=GENITIVE	
gurgitis	gurges	NN	number=SINGULAR|gender=MASCULINE|case=GENITIVE	
alnum	alnus	NN	number=SINGULAR|gender=FEMININE|case=ACCUSATIVE	
infelix	infelix	ADJ	number=SINGULAR|gender=MASCULINE|case=NOMINATIVE	
ne	ne	ADV	_	
-c	que	CONJ	_	
habet	habeo	VB	person=PERSON_3|number=SINGULAR|tense=PR|mood=INDICATIVE|voice=ACTIVE	
quem	qui	PRON	number=SINGULAR|gender=MASCULINE|case=ACCUSATIVE	
porrigat	porrigo	VB	person=PERSON_3|number=SINGULAR|tense=PR|mood=SUBJUNCTIVE|voice=ACTIVE	
ore	os	NN	number=SINGULAR|gender=NEUTER|case=ABLATIVE	
trientem	triens	NN	number=SINGULAR|gender=MASCULINE|case=ACCUSATIVE	
