ea	is	PRON	number=SINGULAR|gender=FEMININE|case=NOMINATIVE	
pars	pars	NN	number=SINGULAR|gender=FEMININE|case=NOMINATIVE	
morum	mos	NN	number=PLURAL|gender=MASCULINE|case=GENITIVE	
eius	is	PRON	number=SINGULAR|gender=MASCULINE|case=GENITIVE	
quo	quo	ADV	_	
suspectior	suspicio	VB	number=SINGULAR|tense=PERF|mood=PARTICIPLE|voice=PASSIVE|gender=MASCULINE|case=NOMINATIVE|degree=COMPARATIVE	
sollicitis	sollicitus	ADJ	number=PLURAL|gender=MASCULINE|case=DATIVE	
adoptanti	adopto	VB	number=SINGULAR|tense=PR|mood=PARTICIPLE|gender=MASCULINE|case=DATIVE	
placebat	placeo	VB	person=PERSON_3|number=SINGULAR|tense=IMP|mood=INDICATIVE|voice=ACTIVE	
erat	sum	VB	person=PERSON_3|number=SINGULAR|tense=IMP|mood=INDICATIVE|voice=ACTIVE	
atrocius	atrox	ADV	degree=COMPARATIVE	
in	in	PREP	_	
urbe	urbs	NN	number=SINGULAR|gender=FEMININE|case=ABLATIVE	
saevitum	saevio	VB	number=SINGULAR|tense=PERF|mood=PARTICIPLE|voice=PASSIVE|gender=NEUTER|case=NOMINATIVE	
nam	nam	CONJ	_	
suadere	suadeo	VB	tense=PR|mood=INFINITIVE|voice=ACTIVE	
principi	princeps	ADJ	number=SINGULAR|gender=MASCULINE|case=DATIVE	
quod	qui	PRON	number=SINGULAR|gender=NEUTER|case=NOMINATIVE	
oporteat	oportet	VB	person=PERSON_3|number=SINGULAR|tense=PR|mood=SUBJUNCTIVE|voice=ACTIVE	
multi	multus	ADJ	number=SINGULAR|gender=MASCULINE|case=GENITIVE	
laboris	labor	NN	number=SINGULAR|gender=MASCULINE|case=GENITIVE	
adsentatio	assentatio	NN	number=SINGULAR|gender=FEMININE|case=NOMINATIVE	
erga	erga	PREP	_	
quemcumque	quicumque	PRON	number=SINGULAR|gender=MASCULINE|case=ACCUSATIVE	
principem	princeps	ADJ	number=SINGULAR|gender=MASCULINE|case=ACCUSATIVE	
sine	sine	PREP	_	
adfectu	affectus	NN	number=SINGULAR|gender=MASCULINE|case=ABLATIVE	
peragitur	perago	VB	person=PERSON_3|number=SINGULAR|tense=PR|mood=INDICATIVE|voice=PASSIVE	
est	sum	VB	person=PERSON_3|number=SINGULAR|tense=PR|mood=INDICATIVE|voice=ACTIVE	
praegravem	praegravis	ADJ	number=SINGULAR|gender=MASCULINE|case=ACCUSATIVE	
se	sui	PRON	number=SINGULAR|gender=MASCULINE|case=ACCUSATIVE	
Neroni	Nero	NN	number=SINGULAR|gender=MASCULINE|case=DATIVE	
fuisse	sum	VB	tense=PERF|mood=INFINITIVE|voice=ACTIVE	
nec	neque	CONJ	_	
Lusitaniam	Lusitania	NN	number=SINGULAR|gender=FEMININE|case=ACCUSATIVE	
rursus	rursus	ADV	_	
et	et	CONJ	_	
alterius	alter	ADJ	number=SINGULAR|gender=NEUTER|case=GENITIVE	
exilii	exsilium	NN	number=SINGULAR|gender=NEUTER|case=GENITIVE	
honorem	honor	NN	number=SINGULAR|gender=MASCULINE|case=ACCUSATIVE	
expectandum	exspecto	VB	number=SINGULAR|mood=GERUNDIVE|gender=MASCULINE|case=ACCUSATIVE	
Potentia	potentia	NN	number=SINGULAR|gender=FEMININE|case=NOMINATIVE	
principatus	principatus	NN	number=SINGULAR|gender=MASCULINE|case=GENITIVE	
divisa	divido	VB	number=SINGULAR|tense=PERF|mood=PARTICIPLE|voice=PASSIVE|gender=FEMININE|case=NOMINATIVE	
in	in	PREP	_	
Titum	Titus	NN	number=SINGULAR|gender=MASCULINE|case=ACCUSATIVE	
Vinium	Vinius	NN	number=SINGULAR|gender=MASCULINE|case=ACCUSATIVE	
consulem	consul	NN	number=SINGULAR|gender=MASCULINE|case=ACCUSATIVE	
Cornelium	Cornelius	NN	number=SINGULAR|gender=MASCULINE|case=ACCUSATIVE	
Laconem	Laco	NN	number=SINGULAR|gender=MASCULINE|case=ACCUSATIVE	
praetorii	praetorius	ADJ	number=SINGULAR|gender=MASCULINE|case=GENITIVE	
praefectum	praeficio	VB	number=SINGULAR|tense=PERF|mood=PARTICIPLE|voice=PASSIVE|gender=MASCULINE|case=ACCUSATIVE	
e	ex	PREP	_	
provinciis	provincia	NN	number=PLURAL|gender=FEMININE|case=ABLATIVE	
Hispaniae	Hispania	NN	number=SINGULAR|gender=FEMININE|case=DATIVE	
praeerat	praesum	VB	person=PERSON_3|number=SINGULAR|tense=IMP|mood=INDICATIVE|voice=ACTIVE	
Cluvius	Cluvius	NN	number=SINGULAR|gender=MASCULINE|case=NOMINATIVE	
Rufus	Rufus	NN	number=SINGULAR|gender=MASCULINE|case=NOMINATIVE	
vir	vir	NN	number=SINGULAR|gender=MASCULINE|case=NOMINATIVE	
facundus	facundus	ADJ	number=SINGULAR|gender=MASCULINE|case=NOMINATIVE	
et	et	CONJ	_	
pacis	pax	NN	number=SINGULAR|gender=FEMININE|case=GENITIVE	
artibus	ars	NN	number=PLURAL|gender=FEMININE|case=ABLATIVE	
bellis	bellum	NN	number=PLURAL|gender=NEUTER|case=ABLATIVE	
inexpertus	inexpertus	ADJ	number=SINGULAR|gender=MASCULINE|case=NOMINATIVE	
paucis	paucus	ADJ	number=PLURAL|gender=MASCULINE|case=DATIVE	
iudicium	judicium	NN	number=SINGULAR|gender=NEUTER|case=NOMINATIVE	
aut	aut	CONJ	_	
rei	res	NN	number=SINGULAR|gender=FEMININE|case=GENITIVE	
publicae	publicus	ADJ	number=SINGULAR|gender=FEMININE|case=GENITIVE	
amor	amor	NN	number=SINGULAR|gender=MASCULINE|case=NOMINATIVE	
fuerat	sum	VB	person=PERSON_3|number=SINGULAR|tense=PLUSQUAMPERFECT|mood=INDICATIVE|voice=ACTIVE	
et	et	CONJ	_	
Nymphidius	Nymphidius	NN	number=SINGULAR|gender=MASCULINE|case=NOMINATIVE	
quidem	quidem	ADV	_	
in	in	PREP	_	
ipso	ipse	PRON	number=SINGULAR|gender=MASCULINE|case=ABLATIVE	
conatu	conatus	NN	number=SINGULAR|gender=MASCULINE|case=ABLATIVE	
oppressus	opprimo	VB	number=SINGULAR|tense=PERF|mood=PARTICIPLE|voice=PASSIVE|gender=MASCULINE|case=NOMINATIVE	
set	sed	CONJ	_	
quamvis	quamvis	ADV	_	
capite	caput	NN	number=SINGULAR|gender=NEUTER|case=ABLATIVE	
defectionis	defectio	NN	number=SINGULAR|gender=FEMININE|case=GENITIVE	
ablato	aufero	VB	number=SINGULAR|tense=PERF|mood=PARTICIPLE|voice=PASSIVE|gender=NEUTER|case=ABLATIVE	
manebat	maneo	VB	person=PERSON_3|number=SINGULAR|tense=IMP|mood=INDICATIVE|voice=ACTIVE	
plerisque	plerusque	ADJ	number=PLURAL|gender=MASCULINE|case=DATIVE	
militum	miles	NN	number=PLURAL|gender=MASCULINE|case=GENITIVE	
conscientia	conscientia	NN	number=SINGULAR|gender=FEMININE|case=NOMINATIVE	
nec	neque	CONJ	_	
deerant	desum	VB	person=PERSON_3|number=PLURAL|tense=IMP|mood=INDICATIVE|voice=ACTIVE	
sermones	sermo	NN	number=PLURAL|gender=MASCULINE|case=NOMINATIVE	
senium	senium	NN	number=SINGULAR|gender=NEUTER|case=ACCUSATIVE	
atque	atque	CONJ	_	
avaritiam	avaritia	NN	number=SINGULAR|gender=FEMININE|case=ACCUSATIVE	
Galbae	Galba	NN	number=SINGULAR|gender=MASCULINE|case=GENITIVE	
increpantium	increpo	VB	number=PLURAL|tense=PR|mood=PARTICIPLE|gender=MASCULINE|case=GENITIVE	
non	non	ADV	_	
sane	sanus	ADV	_	
crebrior	creber	ADJ	number=SINGULAR|gender=MASCULINE|case=NOMINATIVE|degree=COMPARATIVE	
tota	totus	ADJ	number=SINGULAR|gender=FEMININE|case=ABLATIVE	
civitate	civitas	NN	number=SINGULAR|gender=FEMININE|case=ABLATIVE	
sermo	sermo	NN	number=SINGULAR|gender=MASCULINE|case=NOMINATIVE	
per	per	PREP	_	
illos	ille	PRON	number=PLURAL|gender=MASCULINE|case=ACCUSATIVE	
mensis	mensis	NN	number=PLURAL|gender=MASCULINE|case=ACCUSATIVE	
fuerat	sum	VB	person=PERSON_3|number=SINGULAR|tense=PLUSQUAMPERFECT|mood=INDICATIVE|voice=ACTIVE	
primum	primus	ADV	_	
licentia	licentia	NN	number=SINGULAR|gender=FEMININE|case=ABLATIVE	
ac	atque	CONJ	_	
libidine	libido	NN	number=SINGULAR|gender=FEMININE|case=ABLATIVE	
talia	talis	ADJ	number=PLURAL|gender=NEUTER|case=ACCUSATIVE	
loquendi	loquor	VB	mood=GERUND|case=GENITIVE	
dein	deinde	ADV	_	
fessa	fessus	ADJ	number=SINGULAR|gender=FEMININE|case=ABLATIVE	
iam	jam	ADV	_	
aetate	aetas	NN	number=SINGULAR|gender=FEMININE|case=ABLATIVE	
Galbae	Galba	NN	number=SINGULAR|gender=MASCULINE|case=GENITIVE	
exauctorati	exauctoro	VB	number=PLURAL|tense=PERF|mood=PARTICIPLE|voice=PASSIVE|gender=MASCULINE|case=NOMINATIVE	
per	per	PREP	_	
eos	is	PRON	number=PLURAL|gender=MASCULINE|case=ACCUSATIVE	
dies	dies	NN	number=PLURAL|gender=MASCULINE|case=ACCUSATIVE	
tribuni	tribunus	NN	number=PLURAL|gender=MASCULINE|case=NOMINATIVE	
e	ex	PREP	_	
praetorio	praetorius	ADJ	number=SINGULAR|gender=NEUTER|case=ABLATIVE	
Antonius	Antonius	NN	number=SINGULAR|gender=MASCULINE|case=NOMINATIVE	
Taurus	Taurus	NN	number=SINGULAR|gender=MASCULINE|case=NOMINATIVE	
et	et	CONJ	_	
Antonius	Antonius	NN	number=SINGULAR|gender=MASCULINE|case=NOMINATIVE	
Naso	Naso	NN	number=SINGULAR|gender=MASCULINE|case=NOMINATIVE	
ex	ex	PREP	_	
urbanis	urbanus	ADJ	number=PLURAL|gender=FEMININE|case=ABLATIVE	
cohortibus	cohors	NN	number=PLURAL|gender=FEMININE|case=ABLATIVE	
Aemilius	Aemilius	NN	number=SINGULAR|gender=MASCULINE|case=NOMINATIVE	
Pacensis	Pacensis	ADJ	number=SINGULAR|gender=MASCULINE|case=NOMINATIVE	
e	ex	PREP	_	
vigilibus	vigil	ADJ	number=PLURAL|gender=MASCULINE|case=ABLATIVE	
Iulius	Julius	NN	number=SINGULAR|gender=MASCULINE|case=NOMINATIVE	
Fronto	Fronto	NN	number=SINGULAR|gender=MASCULINE|case=NOMINATIVE	
tardum	tardus	ADJ	number=SINGULAR|gender=NEUTER|case=NOMINATIVE	
Galbae	Galba	NN	number=SINGULAR|gender=MASCULINE|case=GENITIVE	
iter	iter	NN	number=SINGULAR|gender=NEUTER|case=NOMINATIVE	
et	et	CONJ	_	
cruentum	cruentus	ADJ	number=SINGULAR|gender=NEUTER|case=NOMINATIVE	
interfectis	interficio	VB	number=PLURAL|tense=PERF|mood=PARTICIPLE|voice=PASSIVE|gender=MASCULINE|case=ABLATIVE	
Cingonio	Cingonius	NN	number=SINGULAR|gender=MASCULINE|case=ABLATIVE	
Varrone	Varro	NN	number=SINGULAR|gender=MASCULINE|case=ABLATIVE	
consule	consul	NN	number=SINGULAR|gender=MASCULINE|case=ABLATIVE	
designato	designo	VB	number=SINGULAR|tense=PERF|mood=PARTICIPLE|voice=PASSIVE|gender=MASCULINE|case=ABLATIVE	
et	et	CONJ	_	
Petronio	Petronius	NN	number=SINGULAR|gender=MASCULINE|case=ABLATIVE	
Turpiliano	Turpilianus	NN	number=SINGULAR|gender=MASCULINE|case=ABLATIVE	
consulari	consularis	ADJ	number=SINGULAR|gender=MASCULINE|case=ABLATIVE	
fuit	sum	VB	person=PERSON_3|number=SINGULAR|tense=PERF|mood=INDICATIVE|voice=ACTIVE	
sub	sub	PREP	_	
Tiberio	Tiberius	NN	number=SINGULAR|gender=MASCULINE|case=ABLATIVE	
et	et	CONJ	_	
Gaio	Gaius	NN	number=SINGULAR|gender=MASCULINE|case=ABLATIVE	
et	et	CONJ	_	
Claudio	Claudius	NN	number=SINGULAR|gender=MASCULINE|case=ABLATIVE	
unius	unus	NRL	number=SINGULAR|gender=FEMININE|case=GENITIVE	
familiae	familia	NN	number=SINGULAR|gender=FEMININE|case=GENITIVE	
quasi	quasi	ADV	_	
hereditas	hereditas	NN	number=SINGULAR|gender=FEMININE|case=NOMINATIVE	
fuimus	sum	VB	person=PERSON_1|number=PLURAL|tense=PERF|mood=INDICATIVE|voice=ACTIVE	
namque	namque	CONJ	_	
Otho	Otho	NN	number=SINGULAR|gender=MASCULINE|case=NOMINATIVE	
pueritiam	pueritia	NN	number=SINGULAR|gender=FEMININE|case=ACCUSATIVE	
incuriose	incuriosus	ADV	_	
adulescentiam	adulescentia	NN	number=SINGULAR|gender=FEMININE|case=ACCUSATIVE	
petulanter	petulans	ADV	_	
egerat	ago	VB	person=PERSON_3|number=SINGULAR|tense=PLUSQUAMPERFECT|mood=INDICATIVE|voice=ACTIVE	
gratus	gratus	ADJ	number=SINGULAR|gender=MASCULINE|case=NOMINATIVE	
Neroni	Nero	NN	number=SINGULAR|gender=MASCULINE|case=DATIVE	
aemulatione	aemulatio	NN	number=SINGULAR|gender=FEMININE|case=ABLATIVE	
luxus	luxus	NN	number=SINGULAR|gender=MASCULINE|case=GENITIVE	
egerat	ago	VB	person=PERSON_3|number=SINGULAR|tense=PLUSQUAMPERFECT|mood=INDICATIVE|voice=ACTIVE	
duae	duo	NRL	number=PLURAL|gender=FEMININE|case=NOMINATIVE	
Mauretaniae	Mauretania	NN	number=PLURAL|gender=FEMININE|case=NOMINATIVE	
Raetia	Raetia	NN	number=SINGULAR|gender=FEMININE|case=NOMINATIVE	
Noricum	Noricum	NN	number=SINGULAR|gender=NEUTER|case=NOMINATIVE	
Thraecia	Thracia	NN	number=SINGULAR|gender=FEMININE|case=NOMINATIVE	
et	et	CONJ	_	
quae	qui	PRON	number=PLURAL|gender=FEMININE|case=NOMINATIVE	
aliae	alius	ADJ	number=PLURAL|gender=FEMININE|case=NOMINATIVE	
procuratoribus	procurator	NN	number=PLURAL|gender=MASCULINE|case=ABLATIVE	
cohibentur	cohibeo	VB	person=PERSON_3|number=PLURAL|tense=PR|mood=INDICATIVE|voice=PASSIVE	
ut	ut	CONJ	_	
cuique	quisque	PRON	number=SINGULAR|gender=MASCULINE|case=DATIVE	
exercitui	exercitus	NN	number=SINGULAR|gender=MASCULINE|case=DATIVE	
vicinae	vicinus	ADJ	number=PLURAL|gender=FEMININE|case=NOMINATIVE	
ita	ita	ADV	_	
in	in	PREP	_	
favorem	favor	NN	number=SINGULAR|gender=MASCULINE|case=ACCUSATIVE	
aut	aut	CONJ	_	
odium	odium	NN	number=SINGULAR|gender=NEUTER|case=ACCUSATIVE	
contactu	contactus	NN	number=SINGULAR|gender=MASCULINE|case=ABLATIVE	
valentiorum	valeo	VB	number=PLURAL|tense=PR|mood=PARTICIPLE|voice=ACTIVE|gender=MASCULINE|case=GENITIVE|degree=COMPARATIVE	
agebantur	ago	VB	person=PERSON_3|number=PLURAL|tense=IMP|mood=INDICATIVE|voice=PASSIVE	
erant	sum	VB	person=PERSON_3|number=PLURAL|tense=IMP|mood=INDICATIVE|voice=ACTIVE	
tribuni	tribunus	NN	number=PLURAL|gender=MASCULINE|case=NOMINATIVE	
tamen	tamen	ADV	_	
centuriones	centurio	NN	number=PLURAL|gender=MASCULINE|case=NOMINATIVE	
-que	que	CONJ	_	
et	et	CONJ	_	
proximi	propior	ADJ	number=PLURAL|gender=MASCULINE|case=NOMINATIVE|degree=SUPERLATIVE	
militum	miles	NN	number=PLURAL|gender=MASCULINE|case=GENITIVE	
grata	gratus	ADJ	number=PLURAL|gender=NEUTER|case=ACCUSATIVE	
auditu	audio	VB	mood=SUBJUNCTIVE|voice=PASSIVE	
respondent	respondeo	VB	person=PERSON_3|number=PLURAL|tense=PR|mood=INDICATIVE|voice=ACTIVE	
sed	sed	CONJ	_	
incorruptam	incorruptus	ADJ	number=SINGULAR|gender=FEMININE|case=ACCUSATIVE	
fidem	fides	NN	number=SINGULAR|gender=FEMININE|case=ACCUSATIVE	
professis	profiteor	VB	number=PLURAL|tense=PERF|mood=PARTICIPLE|voice=DEPONENS|gender=MASCULINE|case=DATIVE	
neque	neque	CONJ	_	
amore	amor	NN	number=SINGULAR|gender=MASCULINE|case=ABLATIVE	
quisquam	quisquam	PRON	number=SINGULAR|gender=MASCULINE|case=NOMINATIVE	
et	et	CONJ	_	
sine	sine	PREP	_	
odio	odium	NN	number=SINGULAR|gender=NEUTER|case=ABLATIVE	
dicendus	dico	VB	number=SINGULAR|mood=GERUNDIVE|gender=MASCULINE|case=NOMINATIVE	
est	sum	VB	person=PERSON_3|number=SINGULAR|tense=PR|mood=INDICATIVE|voice=ACTIVE	
Et	et	CONJ	_	
hic	hic	PRON	number=SINGULAR|gender=MASCULINE|case=NOMINATIVE	
quidem	quidem	ADV	_	
Romae	Roma	NN	number=SINGULAR|gender=FEMININE|case=GENITIVE	
tamquam	tamquam	ADV	_	
in	in	PREP	_	
tanta	tantus	ADJ	number=SINGULAR|gender=FEMININE|case=ABLATIVE	
multitudine	multitudo	NN	number=SINGULAR|gender=FEMININE|case=ABLATIVE	
habitus	habitus	NN	number=SINGULAR|gender=MASCULINE|case=NOMINATIVE	
animorum	animus	NN	number=PLURAL|gender=MASCULINE|case=GENITIVE	
fuit	sum	VB	person=PERSON_3|number=SINGULAR|tense=PERF|mood=INDICATIVE|voice=ACTIVE	
ubique	ubique	ADV	_	
hasta	hasta	NN	number=SINGULAR|gender=FEMININE|case=NOMINATIVE	
et	et	CONJ	_	
sector	sector	NN	number=SINGULAR|gender=MASCULINE|case=NOMINATIVE	
et	et	CONJ	_	
inquieta	inquietus	ADJ	number=SINGULAR|gender=FEMININE|case=NOMINATIVE	
urbs	urbs	NN	number=SINGULAR|gender=FEMININE|case=NOMINATIVE	
actionibus	actio	NN	number=PLURAL|gender=FEMININE|case=ABLATIVE	
fuerunt	sum	VB	person=PERSON_3|number=PLURAL|tense=PERF|mood=INDICATIVE|voice=ACTIVE	
fuit	sum	VB	person=PERSON_3|number=SINGULAR|tense=PERF|mood=INDICATIVE|voice=ACTIVE	
occidi	occido	VB	tense=PR|mood=INFINITIVE|voice=PASSIVE	
Othonem	Otho	NN	number=SINGULAR|gender=MASCULINE|case=ACCUSATIVE	
posse	possum	VB	tense=PR|mood=INFINITIVE|voice=ACTIVE	
seu	sive	CONJ	_	
quae	qui	PRON	number=PLURAL|gender=NEUTER|case=NOMINATIVE	
fato	fatum	NN	number=SINGULAR|gender=NEUTER|case=ABLATIVE	
manent	maneo	VB	person=PERSON_3|number=PLURAL|tense=PR|mood=INDICATIVE|voice=ACTIVE	
quamvis	quamvis	ADV	_	
significata	significo	VB	number=PLURAL|tense=PERF|mood=PARTICIPLE|voice=PASSIVE|gender=NEUTER|case=NOMINATIVE	
non	non	ADV	_	
vitantur	vito	VB	person=PERSON_3|number=PLURAL|tense=PR|mood=INDICATIVE|voice=PASSIVE	
ita	ita	ADV	_	
neutris	neuter	ADJ	number=PLURAL|gender=MASCULINE|case=DATIVE	
cura	cura	NN	number=SINGULAR|gender=FEMININE|case=NOMINATIVE	
posteritatis	posteritas	NN	number=SINGULAR|gender=FEMININE|case=GENITIVE	
inter	inter	PREP	_	
infensos	infensus	ADJ	number=PLURAL|gender=MASCULINE|case=ACCUSATIVE	
vel	vel	CONJ	_	
obnoxios	obnoxius	ADJ	number=PLURAL|gender=MASCULINE|case=ACCUSATIVE	
est	sum	VB	person=PERSON_3|number=SINGULAR|tense=PR|mood=INDICATIVE|voice=ACTIVE	
et	et	CONJ	_	
rumoribus	rumor	NN	number=PLURAL|gender=MASCULINE|case=ABLATIVE	
nihil	nihil	NN	number=SINGULAR|gender=NEUTER	
silentio	silentium	NN	number=SINGULAR|gender=NEUTER|case=ABLATIVE	
transmittentium	transmitto	VB	number=PLURAL|tense=PR|mood=PARTICIPLE|gender=MASCULINE|case=GENITIVE	
quia	quia	CONJ	_	
Vinio	Vinius	NN	number=SINGULAR|gender=MASCULINE|case=DATIVE	
vidua	viduus	ADJ	number=SINGULAR|gender=FEMININE|case=NOMINATIVE	
filia	filia	NN	number=SINGULAR|gender=FEMININE|case=NOMINATIVE	
caelebs	caelebs	ADJ	number=SINGULAR|gender=MASCULINE|case=NOMINATIVE	
Otho	Otho	NN	number=SINGULAR|gender=MASCULINE|case=NOMINATIVE	
gener	gener	NN	number=SINGULAR|gender=MASCULINE|case=NOMINATIVE	
ac	atque	CONJ	_	
socer	socer	NN	number=SINGULAR|gender=MASCULINE|case=NOMINATIVE	
destinabantur	destino	VB	person=PERSON_3|number=PLURAL|tense=IMP|mood=INDICATIVE|voice=PASSIVE	
erat	sum	VB	person=PERSON_3|number=SINGULAR|tense=IMP|mood=INDICATIVE|voice=ACTIVE	
erat	sum	VB	person=PERSON_3|number=SINGULAR|tense=IMP|mood=INDICATIVE|voice=ACTIVE	
ne	ne	ADV	_	
quieto	quiesco	VB	number=SINGULAR|tense=PERF|mood=PARTICIPLE|voice=PASSIVE|gender=MASCULINE|case=ABLATIVE	
quidem	quidem	ADV	_	
milite	miles	NN	number=SINGULAR|gender=MASCULINE|case=ABLATIVE	
regimen	regimen	NN	number=SINGULAR|gender=NEUTER|case=NOMINATIVE	
fuit	sum	VB	person=PERSON_3|number=SINGULAR|tense=PERF|mood=INDICATIVE|voice=ACTIVE	
proximae	propior	ADJ	number=PLURAL|gender=FEMININE|case=NOMINATIVE|degree=SUPERLATIVE	
tamen	tamen	ADV	_	
Germanicis	Germanicus	ADJ	number=PLURAL|gender=MASCULINE|case=DATIVE	
exercitibus	exercitus	NN	number=PLURAL|gender=MASCULINE|case=DATIVE	
Galliarum	Gallia	NN	number=PLURAL|gender=FEMININE|case=GENITIVE	
civitates	civitas	NN	number=PLURAL|gender=FEMININE|case=NOMINATIVE	
non	non	ADV	_	
eodem	idem	PRON	number=SINGULAR|gender=MASCULINE|case=ABLATIVE	
honore	honor	NN	number=SINGULAR|gender=MASCULINE|case=ABLATIVE	
habitae	habeo	VB	number=PLURAL|tense=PERF|mood=PARTICIPLE|voice=PASSIVE|gender=FEMININE|case=NOMINATIVE	
quaedam	quidam	PRON	number=PLURAL|gender=FEMININE|case=NOMINATIVE	
etiam	etiam	CONJ	_	
finibus	finis	NN	number=PLURAL|gender=MASCULINE|case=ABLATIVE	
ademptis	adimo	VB	number=PLURAL|tense=PERF|mood=PARTICIPLE|voice=PASSIVE|gender=MASCULINE|case=ABLATIVE	
pari	par	ADJ	number=SINGULAR|gender=MASCULINE|case=ABLATIVE	
dolore	dolor	NN	number=SINGULAR|gender=MASCULINE|case=ABLATIVE	
commoda	commodus	ADJ	number=PLURAL|gender=NEUTER|case=ACCUSATIVE	
aliena	alienus	ADJ	number=PLURAL|gender=NEUTER|case=ACCUSATIVE	
ac	atque	CONJ	_	
suas	suus	PRON	number=PLURAL|gender=FEMININE|case=ACCUSATIVE	
iniurias	injuria	NN	number=PLURAL|gender=FEMININE|case=ACCUSATIVE	
metiebantur	metior	VB	person=PERSON_3|number=PLURAL|tense=IMP|mood=INDICATIVE|voice=DEPONENS	
opportunos	opportunus	ADJ	number=PLURAL|gender=MASCULINE|case=ACCUSATIVE	
magnis	magnus	ADJ	number=PLURAL|gender=MASCULINE|case=DATIVE	
conatibus	conatus	NN	number=PLURAL|gender=MASCULINE|case=DATIVE	
transitus	transitus	NN	number=PLURAL|gender=MASCULINE|case=ACCUSATIVE	
rerum	res	NN	number=PLURAL|gender=FEMININE|case=GENITIVE	
nec	neque	CONJ	_	
cunctatione	cunctatio	NN	number=SINGULAR|gender=FEMININE|case=ABLATIVE	
opus	opus	NN	number=SINGULAR|gender=NEUTER|case=NOMINATIVE	
ubi	ubi	CONJ	_	
perniciosior	perniciosus	ADJ	number=SINGULAR|gender=FEMININE|case=NOMINATIVE|degree=COMPARATIVE	
sit	sum	VB	person=PERSON_3|number=SINGULAR|tense=PR|mood=SUBJUNCTIVE|voice=ACTIVE	
quies	quies	NN	number=SINGULAR|gender=FEMININE|case=NOMINATIVE	
quam	quam	ADV	_	
temeritas	temeritas	NN	number=SINGULAR|gender=FEMININE|case=NOMINATIVE	
esse	sum	VB	tense=PR|mood=INFINITIVE|voice=ACTIVE	
esse	sum	VB	tense=PR|mood=INFINITIVE|voice=ACTIVE	
sit	sum	VB	person=PERSON_3|number=SINGULAR|tense=PR|mood=SUBJUNCTIVE|voice=ACTIVE	
quippe	quippe	ADV	_	
hiantis	hio	VB	number=PLURAL|tense=PR|mood=PARTICIPLE|gender=FEMININE|case=ACCUSATIVE	
in	in	PREP	_	
magna	magnus	ADJ	number=SINGULAR|gender=FEMININE|case=ABLATIVE	
fortuna	fortuna	NN	number=SINGULAR|gender=FEMININE|case=ABLATIVE	
amicorum	amicus	NN	number=PLURAL|gender=MASCULINE|case=GENITIVE	
cupiditates	cupiditas	NN	number=PLURAL|gender=FEMININE|case=ACCUSATIVE	
ipsa	ipse	PRON	number=SINGULAR|gender=FEMININE|case=NOMINATIVE	
Galbae	Galba	NN	number=SINGULAR|gender=MASCULINE|case=GENITIVE	
facilitas	facilitas	NN	number=SINGULAR|gender=FEMININE|case=NOMINATIVE	
intendebat	intendo	VB	person=PERSON_3|number=SINGULAR|tense=IMP|mood=INDICATIVE|voice=ACTIVE	
cum	cum	CONJ	_	
apud	apud	PREP	_	
infirmum	infirmus	ADJ	number=SINGULAR|gender=MASCULINE|case=ACCUSATIVE	
et	et	CONJ	_	
credulum	credulus	ADJ	number=SINGULAR|gender=MASCULINE|case=ACCUSATIVE	
minore	parvus	ADJ	number=SINGULAR|gender=MASCULINE|case=ABLATIVE|degree=COMPARATIVE	
metu	metus	NN	number=SINGULAR|gender=MASCULINE|case=ABLATIVE	
et	et	CONJ	_	
maiore	magnus	ADJ	number=SINGULAR|gender=NEUTER|case=ABLATIVE|degree=COMPARATIVE	
praemio	praemium	NN	number=SINGULAR|gender=NEUTER|case=ABLATIVE	
peccaretur	pecco	VB	person=PERSON_3|number=SINGULAR|tense=IMP|mood=SUBJUNCTIVE|voice=PASSIVE	
sed	sed	CONJ	_	
callide	callidus	ADV	_	
ut	ut	CONJ	_	
ignotum	ignosco	VB	number=SINGULAR|tense=PERF|mood=PARTICIPLE|voice=PASSIVE|gender=MASCULINE|case=ACCUSATIVE	
fovebat	foveo	VB	person=PERSON_3|number=SINGULAR|tense=IMP|mood=INDICATIVE|voice=ACTIVE	
et	et	CONJ	_	
prospera	prosper	ADJ	number=SINGULAR|gender=FEMININE|case=NOMINATIVE	
de	de	PREP	_	
Pisone	Piso	NN	number=SINGULAR|gender=MASCULINE|case=ABLATIVE	
fama	fama	NN	number=SINGULAR|gender=FEMININE|case=NOMINATIVE	
consilio	consilium	NN	number=SINGULAR|gender=NEUTER|case=DATIVE	
eius	is	PRON	number=SINGULAR|gender=MASCULINE|case=GENITIVE	
fidem	fides	NN	number=SINGULAR|gender=FEMININE|case=ACCUSATIVE	
addiderat	addo	VB	person=PERSON_3|number=SINGULAR|tense=PLUSQUAMPERFECT|mood=INDICATIVE|voice=ACTIVE	
ea	is	PRON	number=SINGULAR|gender=FEMININE|case=NOMINATIVE	
aetas	aetas	NN	number=SINGULAR|gender=FEMININE|case=NOMINATIVE	
tua	tuus	PRON	number=SINGULAR|gender=FEMININE|case=NOMINATIVE	
quae	qui	PRON	number=SINGULAR|gender=FEMININE|case=NOMINATIVE	
cupiditates	cupiditas	NN	number=PLURAL|gender=FEMININE|case=ACCUSATIVE	
adulescentiae	adulescentia	NN	number=SINGULAR|gender=FEMININE|case=GENITIVE	
iam	jam	ADV	_	
effugerit	effugio	VB	person=PERSON_3|number=SINGULAR|tense=PERF|mood=SUBJUNCTIVE|voice=ACTIVE	
ea	is	PRON	number=SINGULAR|gender=FEMININE|case=NOMINATIVE	
vita	vita	NN	number=SINGULAR|gender=FEMININE|case=NOMINATIVE	
in	in	PREP	_	
qua	qui	PRON	number=SINGULAR|gender=FEMININE|case=ABLATIVE	
nihil	nihil	NN	number=SINGULAR|gender=NEUTER	
praeteritum	praetereo	VB	number=SINGULAR|tense=PERF|mood=PARTICIPLE|voice=PASSIVE|gender=NEUTER|case=ACCUSATIVE	
excusandum	excuso	VB	number=SINGULAR|mood=GERUNDIVE|gender=NEUTER|case=ACCUSATIVE	
habeas	habeo	VB	person=PERSON_2|number=SINGULAR|tense=PR|mood=SUBJUNCTIVE|voice=ACTIVE	
est	sum	VB	person=PERSON_3|number=SINGULAR|tense=PR|mood=INDICATIVE|voice=ACTIVE	
est	sum	VB	person=PERSON_3|number=SINGULAR|tense=PR|mood=INDICATIVE|voice=ACTIVE	
id	is	PRON	number=SINGULAR|gender=NEUTER|case=NOMINATIVE	
satis	satis	ADV	_	
videbatur	video	VB	person=PERSON_3|number=SINGULAR|tense=IMP|mood=INDICATIVE|voice=PASSIVE	
Pisonem	Piso	NN	number=SINGULAR|gender=MASCULINE|case=ACCUSATIVE	
ferunt	fero	VB	person=PERSON_3|number=PLURAL|tense=PR|mood=INDICATIVE|voice=ACTIVE	
statim	statim	ADV	_	
intuentibus	intueor	VB	number=PLURAL|tense=PR|mood=PARTICIPLE|gender=MASCULINE|case=DATIVE	
et	et	CONJ	_	
mox	mox	ADV	_	
coniectis	conicio	VB	number=PLURAL|tense=PERF|mood=PARTICIPLE|voice=PASSIVE|gender=MASCULINE|case=ABLATIVE	
in	in	PREP	_	
eum	is	PRON	number=SINGULAR|gender=MASCULINE|case=ACCUSATIVE	
omnium	omnis	ADJ	number=PLURAL|gender=MASCULINE|case=GENITIVE	
oculis	oculus	NN	number=PLURAL|gender=MASCULINE|case=ABLATIVE	
nullum	nullus	ADJ	number=SINGULAR|gender=MASCULINE|case=ACCUSATIVE	
turbati	turbo	VB	number=SINGULAR|tense=PERF|mood=PARTICIPLE|voice=PASSIVE|gender=MASCULINE|case=GENITIVE	
aut	aut	CONJ	_	
exultantis	exsulto	VB	number=SINGULAR|tense=PR|mood=PARTICIPLE|voice=ACTIVE|gender=MASCULINE|case=GENITIVE	
animi	animus	NN	number=SINGULAR|gender=MASCULINE|case=GENITIVE	
motum	motus	NN	number=SINGULAR|gender=MASCULINE|case=ACCUSATIVE	
prodidisse	prodo	VB	tense=PERF|mood=INFINITIVE|voice=ACTIVE	
sed	sed	CONJ	_	
ambitionem	ambitio	NN	number=SINGULAR|gender=FEMININE|case=ACCUSATIVE	
scriptoris	scriptor	NN	number=SINGULAR|gender=MASCULINE|case=GENITIVE	
facile	facilis	ADV	_	
averseris	aversor	VB	person=PERSON_2|number=SINGULAR|tense=PR|mood=SUBJUNCTIVE|voice=DEPONENS	
obtrectatio	obtrectatio	NN	number=SINGULAR|gender=FEMININE|case=NOMINATIVE	
et	et	CONJ	_	
livor	livor	NN	number=SINGULAR|gender=MASCULINE|case=NOMINATIVE	
pronis	pronus	ADJ	number=PLURAL|gender=FEMININE|case=ABLATIVE	
auribus	auris	NN	number=PLURAL|gender=FEMININE|case=ABLATIVE	
accipiuntur	accipio	VB	person=PERSON_3|number=PLURAL|tense=PR|mood=INDICATIVE|voice=PASSIVE	
inducta	induco	VB	number=SINGULAR|tense=PERF|mood=PARTICIPLE|voice=PASSIVE|gender=FEMININE|case=ABLATIVE	
legione	legio	NN	number=SINGULAR|gender=FEMININE|case=ABLATIVE	
Hispana	Hispanus	ADJ	number=SINGULAR|gender=FEMININE|case=ABLATIVE	
remanente	remaneo	VB	number=SINGULAR|tense=PR|mood=PARTICIPLE|gender=FEMININE|case=ABLATIVE	
ea	is	PRON	number=SINGULAR|gender=FEMININE|case=ABLATIVE	
quam	qui	PRON	number=SINGULAR|gender=FEMININE|case=ACCUSATIVE	
e	ex	PREP	_	
classe	classis	NN	number=SINGULAR|gender=FEMININE|case=ABLATIVE	
Nero	Nero	NN	number=SINGULAR|gender=MASCULINE|case=NOMINATIVE	
conscripserat	conscribo	VB	person=PERSON_3|number=SINGULAR|tense=PLUSQUAMPERFECT|mood=INDICATIVE|voice=ACTIVE	
plena	plenus	ADJ	number=SINGULAR|gender=FEMININE|case=NOMINATIVE	
urbs	urbs	NN	number=SINGULAR|gender=FEMININE|case=NOMINATIVE	
exercitu	exercitus	NN	number=SINGULAR|gender=MASCULINE|case=ABLATIVE	
insolito	insolitus	ADJ	number=SINGULAR|gender=MASCULINE|case=ABLATIVE	
fuit	sum	VB	person=PERSON_3|number=SINGULAR|tense=PERF|mood=INDICATIVE|voice=ACTIVE	
Opus	opus	NN	number=SINGULAR|gender=NEUTER|case=ACCUSATIVE	
adgredior	aggredior	VB	person=PERSON_1|number=SINGULAR|tense=PR|mood=INDICATIVE|voice=DEPONENS	
opimum	opimus	ADJ	number=SINGULAR|gender=NEUTER|case=ACCUSATIVE	
casibus	casus	NN	number=PLURAL|gender=MASCULINE|case=ABLATIVE	
atrox	atrox	ADJ	number=SINGULAR|gender=NEUTER|case=ACCUSATIVE	
proeliis	proelium	NN	number=PLURAL|gender=NEUTER|case=ABLATIVE	
discors	discors	ADJ	number=SINGULAR|gender=NEUTER|case=ACCUSATIVE	
seditionibus	seditio	NN	number=PLURAL|gender=FEMININE|case=ABLATIVE	
ipsa	ipse	PRON	number=SINGULAR|gender=FEMININE|case=ABLATIVE	
etiam	etiam	CONJ	_	
pace	pax	NN	number=SINGULAR|gender=FEMININE|case=ABLATIVE	
saevum	saevus	ADJ	number=SINGULAR|gender=NEUTER|case=ACCUSATIVE	
apud	apud	PREP	_	
frequentem	frequens	ADJ	number=SINGULAR|gender=FEMININE|case=ACCUSATIVE	
militum	miles	NN	number=PLURAL|gender=MASCULINE|case=GENITIVE	
contionem	contio	NN	number=SINGULAR|gender=FEMININE|case=ACCUSATIVE	
imperatoria	imperatorius	ADJ	number=SINGULAR|gender=FEMININE|case=ABLATIVE	
brevitate	brevitas	NN	number=SINGULAR|gender=FEMININE|case=ABLATIVE	
adoptari	adopto	VB	tense=PR|mood=INFINITIVE|voice=PASSIVE	
a	ab	PREP	_	
se	sui	PRON	number=SINGULAR|gender=MASCULINE|case=ABLATIVE	
Pisonem	Piso	NN	number=SINGULAR|gender=MASCULINE|case=ACCUSATIVE	
exemplo	exemplum	NN	number=SINGULAR|gender=NEUTER|case=ABLATIVE	
divi	divus	ADJ	number=SINGULAR|gender=MASCULINE|case=GENITIVE	
Augusti	Augustus	NN	number=SINGULAR|gender=MASCULINE|case=GENITIVE	
et	et	CONJ	_	
more	mos	NN	number=SINGULAR|gender=MASCULINE|case=ABLATIVE	
militari	militaris	ADJ	number=SINGULAR|gender=MASCULINE|case=ABLATIVE	
quo	qui	PRON	number=SINGULAR|gender=MASCULINE|case=ABLATIVE	
vir	vir	NN	number=SINGULAR|gender=MASCULINE|case=NOMINATIVE	
virum	vir	NN	number=SINGULAR|gender=MASCULINE|case=ACCUSATIVE	
legeret	lego	VB	person=PERSON_3|number=SINGULAR|tense=IMP|mood=SUBJUNCTIVE|voice=ACTIVE	
pronuntiat	pronuntio	VB	person=PERSON_3|number=SINGULAR|tense=PR|mood=INDICATIVE|voice=ACTIVE	
postquam	postquam	CONJ	_	
bellatum	bello	VB	number=SINGULAR|tense=PERF|mood=PARTICIPLE|voice=PASSIVE|gender=NEUTER|case=NOMINATIVE	
apud	apud	PREP	_	
Actium	Actium	NN	number=SINGULAR|gender=NEUTER|case=ACCUSATIVE	
atque	atque	CONJ	_	
omnem	omnis	ADJ	number=SINGULAR|gender=FEMININE|case=ACCUSATIVE	
potentiam	potentia	NN	number=SINGULAR|gender=FEMININE|case=ACCUSATIVE	
ad	ad	PREP	_	
unum	unus	NRL	number=SINGULAR|gender=MASCULINE|case=ACCUSATIVE	
conferri	confero	VB	tense=PR|mood=INFINITIVE|voice=PASSIVE	
pacis	pax	NN	number=SINGULAR|gender=FEMININE|case=GENITIVE	
interfuit	intersum	VB	person=PERSON_3|number=SINGULAR|tense=PERF|mood=INDICATIVE|voice=ACTIVE	
magna	magnus	ADJ	number=PLURAL|gender=NEUTER|case=NOMINATIVE	
illa	ille	PRON	number=PLURAL|gender=NEUTER|case=NOMINATIVE	
ingenia	ingenium	NN	number=PLURAL|gender=NEUTER|case=NOMINATIVE	
cessere	cedo	VB	person=PERSON_3|number=PLURAL|tense=PERF|mood=INDICATIVE|voice=ACTIVE	
et	et	CONJ	_	
urbs	urbs	NN	number=SINGULAR|gender=FEMININE|case=NOMINATIVE	
incendiis	incendium	NN	number=PLURAL|gender=NEUTER|case=ABLATIVE	
vastata	vasto	VB	number=SINGULAR|tense=PERF|mood=PARTICIPLE|voice=PASSIVE|gender=FEMININE|case=NOMINATIVE	
consumptis	consumo	VB	number=PLURAL|tense=PERF|mood=PARTICIPLE|voice=PASSIVE|gender=NEUTER|case=ABLATIVE	
antiquissimis	antiquus	ADJ	number=PLURAL|gender=NEUTER|case=ABLATIVE|degree=SUPERLATIVE	
delubris	delubrum	NN	number=PLURAL|gender=NEUTER|case=ABLATIVE	
ipso	ipse	PRON	number=SINGULAR|gender=NEUTER|case=ABLATIVE	
Capitolio	Capitolium	NN	number=SINGULAR|gender=NEUTER|case=ABLATIVE	
civium	civis	NN	number=PLURAL|gender=MASCULINE|case=GENITIVE	
manibus	manus	NN	number=PLURAL|gender=FEMININE|case=ABLATIVE	
incenso	incendo	VB	number=SINGULAR|tense=PERF|mood=PARTICIPLE|voice=PASSIVE|gender=NEUTER|case=ABLATIVE	
quotiens	quotiens	ADV	_	
expedierat	expedio	VB	person=PERSON_3|number=SINGULAR|tense=PLUSQUAMPERFECT|mood=INDICATIVE|voice=ACTIVE	
magnae	magnus	ADJ	number=PLURAL|gender=FEMININE|case=NOMINATIVE	
virtutes	virtus	NN	number=PLURAL|gender=FEMININE|case=NOMINATIVE	
fuerant	sum	VB	person=PERSON_3|number=PLURAL|tense=PLUSQUAMPERFECT|mood=INDICATIVE|voice=ACTIVE	
nunc	nunc	ADV	_	
me	ego	PRON	number=SINGULAR|gender=MASCULINE|case=ACCUSATIVE	
deorum	deus	NN	number=PLURAL|gender=MASCULINE|case=GENITIVE	
hominum	homo	NN	number=PLURAL|gender=MASCULINE|case=GENITIVE	
-que	que	CONJ	_	
consensu	consensus	NN	number=SINGULAR|gender=MASCULINE|case=ABLATIVE	
ad	ad	PREP	_	
imperium	imperium	NN	number=SINGULAR|gender=NEUTER|case=ACCUSATIVE	
vocatum	voco	VB	number=SINGULAR|tense=PERF|mood=PARTICIPLE|voice=PASSIVE|gender=MASCULINE|case=ACCUSATIVE	
praeclara	praeclarus	ADJ	number=SINGULAR|gender=FEMININE|case=NOMINATIVE	
indoles	indoles	NN	number=SINGULAR|gender=FEMININE|case=NOMINATIVE	
tua	tuus	PRON	number=SINGULAR|gender=FEMININE|case=NOMINATIVE	
et	et	CONJ	_	
amor	amor	NN	number=SINGULAR|gender=MASCULINE|case=NOMINATIVE	
patriae	patria	NN	number=SINGULAR|gender=FEMININE|case=GENITIVE	
impulit	impello	VB	person=PERSON_3|number=SINGULAR|tense=PERF|mood=INDICATIVE|voice=ACTIVE	
ut	ut	CONJ	_	
principatum	principatus	NN	number=SINGULAR|gender=MASCULINE|case=ACCUSATIVE	
de	de	PREP	_	
quo	qui	PRON	number=SINGULAR|gender=MASCULINE|case=ABLATIVE	
maiores	magnus	ADJ	number=PLURAL|gender=MASCULINE|case=NOMINATIVE|degree=COMPARATIVE	
nostri	noster	PRON	number=PLURAL|gender=MASCULINE|case=NOMINATIVE	
armis	arma	NN	number=PLURAL|gender=NEUTER|case=ABLATIVE	
certabant	certo	VB	person=PERSON_3|number=PLURAL|tense=IMP|mood=INDICATIVE|voice=ACTIVE	
bello	bellum	NN	number=SINGULAR|gender=NEUTER|case=ABLATIVE	
adeptus	adipiscor	VB	number=SINGULAR|tense=PERF|mood=PARTICIPLE|voice=DEPONENS|gender=MASCULINE|case=NOMINATIVE	
quiescenti	quiesco	VB	number=SINGULAR|tense=PR|mood=PARTICIPLE|gender=NEUTER|case=ABLATIVE	
offeram	offero	VB	person=PERSON_1|number=SINGULAR|tense=PR|mood=SUBJUNCTIVE|voice=ACTIVE	
exemplo	exemplum	NN	number=SINGULAR|gender=NEUTER|case=ABLATIVE	
divi	divus	ADJ	number=SINGULAR|gender=MASCULINE|case=GENITIVE	
Augusti	Augustus	NN	number=SINGULAR|gender=MASCULINE|case=GENITIVE	
qui	qui	PRON	number=SINGULAR|gender=MASCULINE|case=NOMINATIVE	
sororis	soror	NN	number=SINGULAR|gender=FEMININE|case=GENITIVE	
filium	filius	NN	number=SINGULAR|gender=MASCULINE|case=ACCUSATIVE	
Marcellum	Marcellus	NN	number=SINGULAR|gender=MASCULINE|case=ACCUSATIVE	
dein	deinde	ADV	_	
generum	gener	NN	number=SINGULAR|gender=MASCULINE|case=ACCUSATIVE	
Agrippam	Agrippa	NN	number=SINGULAR|gender=MASCULINE|case=ACCUSATIVE	
mox	mox	ADV	_	
nepotes	nepos	NN	number=PLURAL|gender=MASCULINE|case=ACCUSATIVE	
suos	suus	PRON	number=PLURAL|gender=MASCULINE|case=ACCUSATIVE	
postremo	posterus	ADV	degree=SUPERLATIVE	
Tiberium	Tiberius	NN	number=SINGULAR|gender=MASCULINE|case=ACCUSATIVE	
Neronem	Nero	NN	number=SINGULAR|gender=MASCULINE|case=ACCUSATIVE	
privignum	privignus	NN	number=SINGULAR|gender=MASCULINE|case=ACCUSATIVE	
in	in	PREP	_	
proximo	propior	ADJ	number=SINGULAR|gender=NEUTER|case=ABLATIVE|degree=SUPERLATIVE	
sibi	sui	PRON	number=SINGULAR|gender=MASCULINE|case=DATIVE	
fastigio	fastigium	NN	number=SINGULAR|gender=NEUTER|case=ABLATIVE	
conlocavit	colloco	VB	person=PERSON_3|number=SINGULAR|tense=PERF|mood=INDICATIVE|voice=ACTIVE	
neque	neque	CONJ	_	
erat	sum	VB	person=PERSON_3|number=SINGULAR|tense=IMP|mood=INDICATIVE|voice=ACTIVE	
Galbae	Galba	NN	number=SINGULAR|gender=MASCULINE|case=DATIVE	
ignota	ignotus	ADJ	number=SINGULAR|gender=FEMININE|case=NOMINATIVE	
Othonis	Otho	NN	number=SINGULAR|gender=MASCULINE|case=GENITIVE	
ac	atque	CONJ	_	
Titi	Titus	NN	number=SINGULAR|gender=MASCULINE|case=GENITIVE	
Vinii	Vinius	NN	number=SINGULAR|gender=MASCULINE|case=GENITIVE	
amicitia	amicitia	NN	number=SINGULAR|gender=FEMININE|case=NOMINATIVE	
mox	mox	ADV	_	
attritis	attero	VB	number=PLURAL|tense=PERF|mood=PARTICIPLE|voice=PASSIVE|gender=FEMININE|case=ABLATIVE	
opibus	ops	NN	number=PLURAL|gender=FEMININE|case=ABLATIVE	
lubrico	lubricus	ADJ	number=SINGULAR|gender=MASCULINE|case=ABLATIVE	
statu	status	NN	number=SINGULAR|gender=MASCULINE|case=ABLATIVE	
suspecta	suspicio	VB	number=SINGULAR|tense=PERF|mood=PARTICIPLE|voice=PASSIVE|gender=FEMININE|case=ABLATIVE	
etiam	etiam	CONJ	_	
Claudii	Claudius	NN	number=SINGULAR|gender=MASCULINE|case=GENITIVE	
iracundia	iracundia	NN	number=SINGULAR|gender=FEMININE|case=ABLATIVE	
in	in	PREP	_	
secretum	secerno	VB	number=SINGULAR|tense=PERF|mood=PARTICIPLE|voice=PASSIVE|gender=NEUTER|case=ACCUSATIVE	
Asiae	Asia	NN	number=SINGULAR|gender=FEMININE|case=GENITIVE	
sepositus	sepono	VB	number=SINGULAR|tense=PERF|mood=PARTICIPLE|voice=PASSIVE|gender=MASCULINE|case=NOMINATIVE	
tam	tam	ADV	_	
prope	prope	ADV	_	
ab	ab	PREP	_	
exule	exsul	NN	number=SINGULAR|gender=MASCULINE|case=ABLATIVE	
fuit	sum	VB	person=PERSON_3|number=SINGULAR|tense=PERF|mood=INDICATIVE|voice=ACTIVE	
quam	quam	ADV	_	
postea	postea	ADV	_	
a	ab	PREP	_	
principe	princeps	ADJ	number=SINGULAR|gender=MASCULINE|case=ABLATIVE	
fuit	sum	VB	person=PERSON_3|number=SINGULAR|tense=PERF|mood=INDICATIVE|voice=ACTIVE	
prope	prope	ADV	_	
nec	neque	CONJ	_	
minus	parvus	ADV	degree=COMPARATIVE	
praemia	praemium	NN	number=PLURAL|gender=NEUTER|case=NOMINATIVE	
delatorum	delator	NN	number=PLURAL|gender=MASCULINE|case=GENITIVE	
invisa	invideo	VB	number=PLURAL|tense=PERF|mood=PARTICIPLE|voice=PASSIVE|gender=NEUTER|case=NOMINATIVE	
quam	quam	ADV	_	
scelera	scelus	NN	number=PLURAL|gender=NEUTER|case=NOMINATIVE	
cum	cum	CONJ	_	
alii	alius	ADJ	number=PLURAL|gender=MASCULINE|case=NOMINATIVE	
sacerdotia	sacerdotium	NN	number=PLURAL|gender=NEUTER|case=ACCUSATIVE	
et	et	CONJ	_	
consulatus	consulatus	NN	number=PLURAL|gender=MASCULINE|case=ACCUSATIVE	
ut	ut	CONJ	_	
spolia	spolium	NN	number=PLURAL|gender=NEUTER|case=ACCUSATIVE	
adepti	adipiscor	VB	number=PLURAL|tense=PERF|mood=PARTICIPLE|voice=DEPONENS|gender=MASCULINE|case=NOMINATIVE	
procurationes	procuratio	NN	number=PLURAL|gender=FEMININE|case=ACCUSATIVE	
alii	alius	ADJ	number=PLURAL|gender=MASCULINE|case=NOMINATIVE	
et	et	CONJ	_	
interiorem	interior	ADJ	number=SINGULAR|gender=FEMININE|case=ACCUSATIVE|degree=COMPARATIVE	
potentiam	potentia	NN	number=SINGULAR|gender=FEMININE|case=ACCUSATIVE	
agerent	ago	VB	person=PERSON_3|number=PLURAL|tense=IMP|mood=SUBJUNCTIVE|voice=ACTIVE	
verterent	verto	VB	person=PERSON_3|number=PLURAL|tense=IMP|mood=SUBJUNCTIVE|voice=ACTIVE	
cuncta	cunctus	ADJ	number=PLURAL|gender=NEUTER|case=ACCUSATIVE	
odio	odium	NN	number=SINGULAR|gender=NEUTER|case=ABLATIVE	
et	et	CONJ	_	
terrore	terror	NN	number=SINGULAR|gender=MASCULINE|case=ABLATIVE	
adepti	adipiscor	VB	number=PLURAL|tense=PERF|mood=PARTICIPLE|voice=DEPONENS|gender=MASCULINE|case=NOMINATIVE	
invisa	invideo	VB	number=PLURAL|tense=PERF|mood=PARTICIPLE|voice=PASSIVE|gender=NEUTER|case=NOMINATIVE	
Initium	initium	NN	number=SINGULAR|gender=NEUTER|case=NOMINATIVE	
mihi	ego	PRON	number=SINGULAR|gender=MASCULINE|case=DATIVE	
operis	opus	NN	number=SINGULAR|gender=NEUTER|case=GENITIVE	
Servius	Servius	NN	number=SINGULAR|gender=MASCULINE|case=NOMINATIVE	
Galba	Galba	NN	number=SINGULAR|gender=MASCULINE|case=NOMINATIVE	
iterum	iterum	ADV	_	
Titus	Titus	NN	number=SINGULAR|gender=MASCULINE|case=NOMINATIVE	
Vinius	Vinius	NN	number=SINGULAR|gender=MASCULINE|case=NOMINATIVE	
consules	consul	NN	number=PLURAL|gender=MASCULINE|case=NOMINATIVE	
erunt	sum	VB	person=PERSON_3|number=PLURAL|tense=FUTURE|mood=INDICATIVE|voice=ACTIVE	
fuere	sum	VB	person=PERSON_3|number=PLURAL|tense=PERF|mood=INDICATIVE|voice=ACTIVE	
qui	qui	PRON	number=PLURAL|gender=MASCULINE|case=NOMINATIVE	
crederent	credo	VB	person=PERSON_3|number=PLURAL|tense=IMP|mood=SUBJUNCTIVE|voice=ACTIVE	
Capitonem	Capito	NN	number=SINGULAR|gender=MASCULINE|case=ACCUSATIVE	
ut	ut	CONJ	_	
avaritia	avaritia	NN	number=SINGULAR|gender=FEMININE|case=ABLATIVE	
et	et	CONJ	_	
libidine	libido	NN	number=SINGULAR|gender=FEMININE|case=ABLATIVE	
foedum	foedus	ADJ	number=SINGULAR|gender=MASCULINE|case=ACCUSATIVE	
ac	atque	CONJ	_	
maculosum	maculosus	ADJ	number=SINGULAR|gender=MASCULINE|case=ACCUSATIVE	
ita	ita	ADV	_	
cogitatione	cogitatio	NN	number=SINGULAR|gender=FEMININE|case=ABLATIVE	
rerum	res	NN	number=PLURAL|gender=FEMININE|case=GENITIVE	
novarum	novus	ADJ	number=PLURAL|gender=FEMININE|case=GENITIVE	
abstinuisse	abstineo	VB	tense=PERF|mood=INFINITIVE|voice=ACTIVE	
sed	sed	CONJ	_	
a	ab	PREP	_	
legatis	legatus	NN	number=PLURAL|gender=MASCULINE|case=ABLATIVE	
bellum	bellum	NN	number=SINGULAR|gender=NEUTER|case=ACCUSATIVE	
suadentibus	suadeo	VB	number=PLURAL|tense=PR|mood=PARTICIPLE|gender=MASCULINE|case=ABLATIVE	
postquam	postquam	CONJ	_	
impellere	impello	VB	tense=PR|mood=INFINITIVE|voice=ACTIVE	
nequiverint	nequeo	VB	person=PERSON_3|number=PLURAL|tense=PERF|mood=SUBJUNCTIVE|voice=ACTIVE	
crimen	crimen	NN	number=SINGULAR|gender=NEUTER|case=ACCUSATIVE	
ac	atque	CONJ	_	
dolum	dolus	NN	number=SINGULAR|gender=MASCULINE|case=ACCUSATIVE	
ultro	ultro	ADV	_	
compositum	compono	VB	number=SINGULAR|tense=PERF|mood=PARTICIPLE|voice=PASSIVE|gender=MASCULINE|case=ACCUSATIVE	
et	et	CONJ	_	
Galbam	Galba	NN	number=SINGULAR|gender=MASCULINE|case=ACCUSATIVE	
mobilitate	mobilitas	NN	number=SINGULAR|gender=FEMININE|case=ABLATIVE	
ingenii	ingenium	NN	number=SINGULAR|gender=NEUTER|case=GENITIVE	
an	an	CONJ	_	
ne	ne	CONJ	_	
altius	altus	ADV	degree=COMPARATIVE	
scrutaretur	scrutor	VB	person=PERSON_3|number=SINGULAR|tense=IMP|mood=SUBJUNCTIVE|voice=DEPONENS	
quoquo	quisquis	PRON	number=SINGULAR|gender=MASCULINE|case=ABLATIVE	
modo	modus	NN	number=SINGULAR|gender=MASCULINE|case=ABLATIVE	
acta	ago	VB	number=PLURAL|tense=PERF|mood=PARTICIPLE|voice=PASSIVE|gender=NEUTER|case=ACCUSATIVE	
quia	quia	CONJ	_	
mutari	muto	VB	tense=PR|mood=INFINITIVE|voice=PASSIVE	
non	non	ADV	_	
poterant	possum	VB	person=PERSON_3|number=PLURAL|tense=IMP|mood=INDICATIVE|voice=ACTIVE	
comprobasse	comprobo	VB	tense=PERF|mood=INFINITIVE|voice=ACTIVE	
fuisse	sum	VB	tense=PERF|mood=INFINITIVE|voice=ACTIVE	
nunc	nunc	ADV	_	
eo	eo	ADV	_	
necessitatis	necessitas	NN	number=SINGULAR|gender=FEMININE|case=GENITIVE	
iam	jam	ADV	_	
pridem	pridem	ADV	_	
ventum	venio	VB	number=SINGULAR|tense=PERF|mood=PARTICIPLE|voice=PASSIVE|gender=NEUTER|case=NOMINATIVE	
est	sum	VB	person=PERSON_3|number=SINGULAR|tense=PR|mood=INDICATIVE|voice=ACTIVE	
ut	ut	CONJ	_	
nec	neque	CONJ	_	
mea	meus	PRON	number=SINGULAR|gender=FEMININE|case=NOMINATIVE	
senectus	senectus	NN	number=SINGULAR|gender=FEMININE|case=NOMINATIVE	
conferre	confero	VB	tense=PR|mood=INFINITIVE|voice=ACTIVE	
plus	multus	ADV	degree=COMPARATIVE	
populo	populus	NN	number=SINGULAR|gender=MASCULINE|case=DATIVE	
Romano	Romanus	ADJ	number=SINGULAR|gender=MASCULINE|case=DATIVE	
possit	possum	VB	person=PERSON_3|number=SINGULAR|tense=PR|mood=SUBJUNCTIVE|voice=ACTIVE	
quam	quam	ADV	_	
bonum	bonus	ADJ	number=SINGULAR|gender=MASCULINE|case=ACCUSATIVE	
successorem	successor	NN	number=SINGULAR|gender=MASCULINE|case=ACCUSATIVE	
nec	neque	CONJ	_	
tua	tuus	PRON	number=SINGULAR|gender=FEMININE|case=NOMINATIVE	
plus	multus	ADV	degree=COMPARATIVE	
iuventa	juventa	NN	number=SINGULAR|gender=FEMININE|case=NOMINATIVE	
quam	quam	ADV	_	
bonum	bonus	ADJ	number=SINGULAR|gender=MASCULINE|case=ACCUSATIVE	
principem	princeps	ADJ	number=SINGULAR|gender=MASCULINE|case=ACCUSATIVE	
conferre	confero	VB	tense=PR|mood=INFINITIVE|voice=ACTIVE	
conferre	confero	VB	tense=PR|mood=INFINITIVE|voice=ACTIVE	
possit	possum	VB	person=PERSON_3|number=SINGULAR|tense=PR|mood=SUBJUNCTIVE|voice=ACTIVE	
conferre	confero	VB	tense=PR|mood=INFINITIVE|voice=ACTIVE	
nam	nam	CONJ	_	
generari	genero	VB	tense=PR|mood=INFINITIVE|voice=PASSIVE	
et	et	CONJ	_	
nasci	nascor	VB	tense=PR|mood=INFINITIVE|voice=DEPONENS	
a	ab	PREP	_	
principibus	princeps	ADJ	number=PLURAL|gender=MASCULINE|case=ABLATIVE	
fortuitum	fortuitus	ADJ	number=SINGULAR|gender=NEUTER|case=NOMINATIVE	
nec	neque	CONJ	_	
ultra	ultra	ADV	_	
aestimatur	aestimo	VB	person=PERSON_3|number=SINGULAR|tense=PR|mood=INDICATIVE|voice=PASSIVE	
est	sum	VB	person=PERSON_3|number=SINGULAR|tense=PR|mood=INDICATIVE|voice=ACTIVE	
quem	qui	PRON	number=SINGULAR|gender=MASCULINE|case=ACCUSATIVE	
non	non	ADV	_	
remitti	remitto	VB	tense=PR|mood=INFINITIVE|voice=PASSIVE	
atque	atque	CONJ	_	
etiam	etiam	CONJ	_	
reum	reus	NN	number=SINGULAR|gender=MASCULINE|case=ACCUSATIVE	
esse	sum	VB	tense=PR|mood=INFINITIVE|voice=ACTIVE	
tamquam	tamquam	ADV	_	
suum	suus	PRON	number=SINGULAR|gender=NEUTER|case=ACCUSATIVE	
crimen	crimen	NN	number=SINGULAR|gender=NEUTER|case=ACCUSATIVE	
accipiebant	accipio	VB	person=PERSON_3|number=PLURAL|tense=IMP|mood=INDICATIVE|voice=ACTIVE	
esset	sum	VB	person=PERSON_3|number=SINGULAR|tense=IMP|mood=SUBJUNCTIVE|voice=ACTIVE	
et	et	CONJ	_	
finita	finio	VB	number=SINGULAR|tense=PERF|mood=PARTICIPLE|voice=PASSIVE|gender=FEMININE|case=ABLATIVE	
Iuliorum	Julius	NN	number=PLURAL|gender=MASCULINE|case=GENITIVE	
Claudiorum	Claudius	NN	number=PLURAL|gender=MASCULINE|case=GENITIVE	
-que	que	CONJ	_	
domo	domus	NN	number=SINGULAR|gender=FEMININE|case=ABLATIVE	
optimum	bonus	ADJ	number=SINGULAR|gender=MASCULINE|case=ACCUSATIVE|degree=SUPERLATIVE	
quemque	quisque	PRON	number=SINGULAR|gender=MASCULINE|case=ACCUSATIVE	
adoptio	adoptio	NN	number=SINGULAR|gender=FEMININE|case=NOMINATIVE	
inveniet	invenio	VB	person=PERSON_3|number=SINGULAR|tense=FUTURE|mood=INDICATIVE|voice=ACTIVE	
supremae	superus	ADJ	number=PLURAL|gender=FEMININE|case=NOMINATIVE|degree=SUPERLATIVE	
clarorum	clarus	ADJ	number=PLURAL|gender=MASCULINE|case=GENITIVE	
virorum	vir	NN	number=PLURAL|gender=MASCULINE|case=GENITIVE	
necessitates	necessitas	NN	number=PLURAL|gender=FEMININE|case=NOMINATIVE	
fortiter	fortis	ADV	_	
toleratae	tolero	VB	number=PLURAL|tense=PERF|mood=PARTICIPLE|voice=PASSIVE|gender=FEMININE|case=NOMINATIVE	
et	et	CONJ	_	
laudatis	laudo	VB	number=PLURAL|tense=PERF|mood=PARTICIPLE|voice=PASSIVE|gender=FEMININE|case=DATIVE	
antiquorum	antiquus	ADJ	number=PLURAL|gender=MASCULINE|case=GENITIVE	
mortibus	mors	NN	number=PLURAL|gender=FEMININE|case=DATIVE	
pares	par	ADJ	number=PLURAL|gender=MASCULINE|case=NOMINATIVE	
exitus	exitus	NN	number=PLURAL|gender=MASCULINE|case=NOMINATIVE	
fuerunt	sum	VB	person=PERSON_3|number=PLURAL|tense=PERF|mood=INDICATIVE|voice=ACTIVE	
inermes	inermis	ADJ	number=PLURAL|gender=FEMININE|case=NOMINATIVE	
provinciae	provincia	NN	number=PLURAL|gender=FEMININE|case=NOMINATIVE	
atque	atque	CONJ	_	
ipsa	ipse	PRON	number=SINGULAR|gender=FEMININE|case=NOMINATIVE	
in	in	PREP	_	
primis	primus	NRL	number=PLURAL|gender=NEUTER|case=ABLATIVE	
Italia	Italia	NN	number=SINGULAR|gender=FEMININE|case=NOMINATIVE	
cuicumque	quicumque	PRON	number=SINGULAR|gender=NEUTER|case=DATIVE	
servitio	servitium	NN	number=SINGULAR|gender=NEUTER|case=DATIVE	
exposita	expono	VB	number=SINGULAR|tense=PERF|mood=PARTICIPLE|voice=PASSIVE|gender=FEMININE|case=NOMINATIVE	
in	in	PREP	_	
pretium	pretium	NN	number=SINGULAR|gender=NEUTER|case=ACCUSATIVE	
belli	bellum	NN	number=SINGULAR|gender=NEUTER|case=GENITIVE	
cessurae	cedo	VB	number=PLURAL|tense=FUTURE|mood=PARTICIPLE|voice=ACTIVE|gender=FEMININE|case=NOMINATIVE	
erant	sum	VB	person=PERSON_3|number=PLURAL|tense=IMP|mood=INDICATIVE|voice=ACTIVE	
Igitur	igitur	CONJ	_	
Galba	Galba	NN	number=SINGULAR|gender=MASCULINE|case=NOMINATIVE	
adprehensa	apprehendo	VB	number=SINGULAR|tense=PERF|mood=PARTICIPLE|voice=PASSIVE|gender=FEMININE|case=ABLATIVE	
Pisonis	Piso	NN	number=SINGULAR|gender=MASCULINE|case=GENITIVE	
manu	manus	NN	number=SINGULAR|gender=FEMININE|case=ABLATIVE	
in	in	PREP	_	
hunc	hic	PRON	number=SINGULAR|gender=MASCULINE|case=ACCUSATIVE	
modum	modus	NN	number=SINGULAR|gender=MASCULINE|case=ACCUSATIVE	
locutus	loquor	VB	number=SINGULAR|tense=PERF|mood=PARTICIPLE|voice=DEPONENS|gender=MASCULINE|case=NOMINATIVE	
fertur	fero	VB	person=PERSON_3|number=SINGULAR|tense=PR|mood=INDICATIVE|voice=PASSIVE	
etiam	etiam	CONJ	_	
si	si	CONJ	_	
ego	ego	PRON	number=SINGULAR|gender=MASCULINE|case=NOMINATIVE	
ac	atque	CONJ	_	
tu	tu	PRON	number=SINGULAR|gender=MASCULINE|case=NOMINATIVE	
simplicissime	simplex	ADV	degree=SUPERLATIVE	
inter	inter	PREP	_	
nos	nos	PRON	number=PLURAL|gender=MASCULINE|case=ACCUSATIVE	
hodie	hodie	ADV	_	
loquimur	loquor	VB	person=PERSON_1|number=PLURAL|tense=PR|mood=INDICATIVE|voice=DEPONENS	
ceteri	ceterus	ADJ	number=PLURAL|gender=MASCULINE|case=NOMINATIVE	
libentius	libet	ADV	degree=COMPARATIVE	
cum	cum	PREP	_	
fortuna	fortuna	NN	number=SINGULAR|gender=FEMININE|case=ABLATIVE	
nostra	noster	PRON	number=SINGULAR|gender=FEMININE|case=ABLATIVE	
quam	quam	ADV	_	
nobiscum	nos	PRON	number=PLURAL|gender=MASCULINE|case=ABLATIVE	
loquuntur	loquor	VB	person=PERSON_3|number=PLURAL|tense=PR|mood=INDICATIVE|voice=DEPONENS	
loquuntur	loquor	VB	person=PERSON_3|number=PLURAL|tense=PR|mood=INDICATIVE|voice=DEPONENS	
neque	neque	CONJ	_	
erat	sum	VB	person=PERSON_3|number=SINGULAR|tense=IMP|mood=INDICATIVE|voice=ACTIVE	
adhuc	adhuc	ADV	_	
damnati	damno	VB	number=SINGULAR|tense=PERF|mood=PARTICIPLE|voice=PASSIVE|gender=MASCULINE|case=GENITIVE	
principis	princeps	ADJ	number=SINGULAR|gender=MASCULINE|case=GENITIVE	
exemplum	exemplum	NN	number=SINGULAR|gender=NEUTER|case=NOMINATIVE	
inferioris	inferus	ADJ	number=SINGULAR|gender=FEMININE|case=GENITIVE|degree=COMPARATIVE	
Germaniae	Germania	NN	number=SINGULAR|gender=FEMININE|case=GENITIVE	
legiones	legio	NN	number=PLURAL|gender=FEMININE|case=NOMINATIVE	
diutius	diu	ADV	degree=COMPARATIVE	
sine	sine	PREP	_	
consulari	consularis	ADJ	number=SINGULAR|gender=MASCULINE|case=ABLATIVE	
fuere	sum	VB	person=PERSON_3|number=PLURAL|tense=PERF|mood=INDICATIVE|voice=ACTIVE	
donec	donec	CONJ	_	
missu	missus	NN	number=SINGULAR|gender=MASCULINE|case=ABLATIVE	
Galbae	Galba	NN	number=SINGULAR|gender=MASCULINE|case=GENITIVE	
A.	Aulus	NN	number=SINGULAR|gender=MASCULINE|case=NOMINATIVE	
Vitellius	Vitellius	NN	number=SINGULAR|gender=MASCULINE|case=NOMINATIVE	
aderat	adsum	VB	person=PERSON_3|number=SINGULAR|tense=IMP|mood=INDICATIVE|voice=ACTIVE	
censoris	censor	NN	number=SINGULAR|gender=MASCULINE|case=GENITIVE	
Vitellii	Vitellius	NN	number=SINGULAR|gender=MASCULINE|case=GENITIVE	
ac	atque	CONJ	_	
ter	ter	ADV	_	
consulis	consul	NN	number=SINGULAR|gender=MASCULINE|case=GENITIVE	
filius	filius	NN	number=SINGULAR|gender=MASCULINE|case=NOMINATIVE	
placebat	placeo	VB	person=PERSON_3|number=SINGULAR|tense=IMP|mood=INDICATIVE|voice=ACTIVE	
et	et	CONJ	_	
Laconem	Laco	NN	number=SINGULAR|gender=MASCULINE|case=ACCUSATIVE	
praetorii	praetorius	ADJ	number=SINGULAR|gender=NEUTER|case=GENITIVE	
praefectum	praeficio	VB	number=SINGULAR|tense=PERF|mood=PARTICIPLE|voice=PASSIVE|gender=MASCULINE|case=ACCUSATIVE	
simul	simul	ADV	_	
mitti	mitto	VB	tense=PR|mood=INFINITIVE|voice=PASSIVE	
insignis	insignis	ADJ	number=PLURAL|gender=FEMININE|case=ACCUSATIVE	
amicitias	amicitia	NN	number=PLURAL|gender=FEMININE|case=ACCUSATIVE	
iuvenis	juvenis	ADJ	number=SINGULAR|gender=MASCULINE|case=NOMINATIVE	
ambitiose	ambitiosus	ADV	_	
coluerat	colo	VB	person=PERSON_3|number=SINGULAR|tense=PLUSQUAMPERFECT|mood=INDICATIVE|voice=ACTIVE	
quod	quod	CONJ	_	
si	si	CONJ	_	
vita	vita	NN	number=SINGULAR|gender=FEMININE|case=NOMINATIVE	
suppeditet	suppedito	VB	person=PERSON_3|number=SINGULAR|tense=PR|mood=SUBJUNCTIVE|voice=ACTIVE	
principatum	principatus	NN	number=SINGULAR|gender=MASCULINE|case=ACCUSATIVE	
divi	divus	ADJ	number=SINGULAR|gender=MASCULINE|case=GENITIVE	
Nervae	Nerva	NN	number=SINGULAR|gender=MASCULINE|case=GENITIVE	
et	et	CONJ	_	
imperium	imperium	NN	number=SINGULAR|gender=NEUTER|case=ACCUSATIVE	
Traiani	Trajanus	NN	number=SINGULAR|gender=MASCULINE|case=GENITIVE	
uberiorem	uber	ADJ	number=SINGULAR|gender=FEMININE|case=ACCUSATIVE|degree=COMPARATIVE	
securiorem	securus	ADJ	number=SINGULAR|gender=FEMININE|case=ACCUSATIVE|degree=COMPARATIVE	
-que	que	CONJ	_	
materiam	materia	NN	number=SINGULAR|gender=FEMININE|case=ACCUSATIVE	
senectuti	senectus	NN	number=SINGULAR|gender=FEMININE|case=DATIVE	
seposui	sepono	VB	person=PERSON_1|number=SINGULAR|tense=PERF|mood=INDICATIVE|voice=ACTIVE	
rara	rarus	ADJ	number=SINGULAR|gender=FEMININE|case=ABLATIVE	
temporum	tempus	NN	number=PLURAL|gender=NEUTER|case=GENITIVE	
felicitate	felicitas	NN	number=SINGULAR|gender=FEMININE|case=ABLATIVE	
ubi	ubi	ADV	_	
sentire	sentio	VB	tense=PR|mood=INFINITIVE|voice=ACTIVE	
quae	qui	PRON	number=PLURAL|gender=NEUTER|case=ACCUSATIVE	
velis	volo	VB	person=PERSON_2|number=SINGULAR|tense=PR|mood=SUBJUNCTIVE|voice=ACTIVE	
et	et	CONJ	_	
quae	qui	PRON	number=PLURAL|gender=NEUTER|case=ACCUSATIVE	
sentias	sentio	VB	person=PERSON_2|number=SINGULAR|tense=PR|mood=SUBJUNCTIVE|voice=ACTIVE	
dicere	dico	VB	tense=PR|mood=INFINITIVE|voice=ACTIVE	
licet	licet	VB	person=PERSON_3|number=SINGULAR|tense=PR|mood=INDICATIVE|voice=ACTIVE	
Quartum	quartus	NRL	number=SINGULAR|gender=MASCULINE|case=ACCUSATIVE	
idus	idus	NN	number=PLURAL|gender=FEMININE|case=ACCUSATIVE	
Ianuarias	Januarius	ADJ	number=PLURAL|gender=FEMININE|case=ACCUSATIVE	
foedum	foedus	ADJ	number=SINGULAR|gender=MASCULINE|case=ACCUSATIVE	
imbribus	imber	NN	number=PLURAL|gender=MASCULINE|case=ABLATIVE	
diem	dies	NN	number=SINGULAR|gender=MASCULINE|case=ACCUSATIVE	
tonitrua	tonitruum	NN	number=PLURAL|gender=NEUTER|case=NOMINATIVE	
et	et	CONJ	_	
fulgura	fulgur	NN	number=PLURAL|gender=NEUTER|case=NOMINATIVE	
et	et	CONJ	_	
caelestes	caelestis	ADJ	number=PLURAL|gender=FEMININE|case=NOMINATIVE	
minae	minae	NN	number=PLURAL|gender=FEMININE|case=NOMINATIVE	
ultra	ultra	PREP	_	
solitum	soleo	VB	number=SINGULAR|tense=PERF|mood=PARTICIPLE|voice=PASSIVE|gender=NEUTER|case=ACCUSATIVE	
turbaverunt	turbo	VB	person=PERSON_3|number=PLURAL|tense=PERF|mood=INDICATIVE|voice=ACTIVE	
consultatum	consulto	VB	number=SINGULAR|tense=PERF|mood=PARTICIPLE|voice=PASSIVE|gender=NEUTER|case=NOMINATIVE	
inde	inde	ADV	_	
pro	pro	PREP	_	
rostris	rostrum	NN	number=PLURAL|gender=NEUTER|case=ABLATIVE	
an	an	CONJ	_	
in	in	PREP	_	
senatu	senatus	NN	number=SINGULAR|gender=MASCULINE|case=ABLATIVE	
an	an	CONJ	_	
in	in	PREP	_	
castris	castrum	NN	number=PLURAL|gender=NEUTER|case=ABLATIVE	
adoptio	adoptio	NN	number=SINGULAR|gender=FEMININE|case=NOMINATIVE	
nuncuparetur	nuncupo	VB	person=PERSON_3|number=SINGULAR|tense=IMP|mood=SUBJUNCTIVE|voice=PASSIVE	
iam	jam	ADV	_	
vero	verus	ADV	_	
Italia	Italia	NN	number=SINGULAR|gender=FEMININE|case=NOMINATIVE	
novis	novus	ADJ	number=PLURAL|gender=FEMININE|case=ABLATIVE	
cladibus	clades	NN	number=PLURAL|gender=FEMININE|case=ABLATIVE	
vel	vel	CONJ	_	
post	post	PREP	_	
longam	longus	ADJ	number=SINGULAR|gender=FEMININE|case=ACCUSATIVE	
saeculorum	saeculum	NN	number=PLURAL|gender=NEUTER|case=GENITIVE	
seriem	series	NN	number=SINGULAR|gender=FEMININE|case=ACCUSATIVE	
repetitis	repeto	VB	number=PLURAL|tense=PERF|mood=PARTICIPLE|voice=PASSIVE|gender=FEMININE|case=ABLATIVE	
adflicta	affligo	VB	number=SINGULAR|tense=PERF|mood=PARTICIPLE|voice=PASSIVE|gender=FEMININE|case=NOMINATIVE	
Ceterum	ceterus	ADV	_	
antequam	antequam	CONJ	_	
destinata	destino	VB	number=PLURAL|tense=PERF|mood=PARTICIPLE|voice=PASSIVE|gender=NEUTER|case=ACCUSATIVE	
componam	compono	VB	person=PERSON_1|number=SINGULAR|tense=PR|mood=SUBJUNCTIVE|voice=ACTIVE	
repetendum	repeto	VB	number=SINGULAR|mood=GERUNDIVE|gender=NEUTER|case=NOMINATIVE	
videtur	video	VB	person=PERSON_3|number=SINGULAR|tense=PR|mood=INDICATIVE|voice=PASSIVE	
qualis	qualis	ADJ	number=SINGULAR|gender=MASCULINE|case=NOMINATIVE	
status	status	NN	number=SINGULAR|gender=MASCULINE|case=NOMINATIVE	
urbis	urbs	NN	number=SINGULAR|gender=FEMININE|case=GENITIVE	
quae	qui	PRON	number=SINGULAR|gender=FEMININE|case=NOMINATIVE	
mens	mens	NN	number=SINGULAR|gender=FEMININE|case=NOMINATIVE	
exercituum	exercitus	NN	number=PLURAL|gender=MASCULINE|case=GENITIVE	
quis	quis	PRON	number=SINGULAR|gender=MASCULINE|case=NOMINATIVE	
habitus	habitus	NN	number=PLURAL|gender=MASCULINE|case=NOMINATIVE	
provinciarum	provincia	NN	number=PLURAL|gender=FEMININE|case=GENITIVE	
quid	quis	PRON	number=SINGULAR|gender=NEUTER|case=NOMINATIVE	
in	in	PREP	_	
toto	totus	ADJ	number=SINGULAR|gender=MASCULINE|case=ABLATIVE	
terrarum	terra	NN	number=PLURAL|gender=FEMININE|case=GENITIVE	
orbe	orbis	NN	number=SINGULAR|gender=MASCULINE|case=ABLATIVE	
validum	validus	ADJ	number=SINGULAR|gender=NEUTER|case=NOMINATIVE	
quid	quis	PRON	number=SINGULAR|gender=NEUTER|case=NOMINATIVE	
aegrum	aeger	ADJ	number=SINGULAR|gender=NEUTER|case=NOMINATIVE	
fuerit	sum	VB	person=PERSON_3|number=SINGULAR|tense=PERF|mood=SUBJUNCTIVE|voice=ACTIVE	
ut	ut	CONJ	_	
non	non	ADV	_	
modo	modo	ADV	_	
casus	casus	NN	number=PLURAL|gender=MASCULINE|case=NOMINATIVE	
eventus	eventus	NN	number=PLURAL|gender=MASCULINE|case=NOMINATIVE	
-que	que	CONJ	_	
rerum	res	NN	number=PLURAL|gender=FEMININE|case=GENITIVE	
qui	qui	PRON	number=PLURAL|gender=MASCULINE|case=NOMINATIVE	
plerumque	plerusque	ADV	_	
fortuiti	fortuitus	ADJ	number=PLURAL|gender=MASCULINE|case=NOMINATIVE	
sunt	sum	VB	person=PERSON_3|number=PLURAL|tense=PR|mood=INDICATIVE|voice=ACTIVE	
sed	sed	CONJ	_	
ratio	ratio	NN	number=SINGULAR|gender=FEMININE|case=NOMINATIVE	
etiam	etiam	CONJ	_	
causae	causa	NN	number=PLURAL|gender=FEMININE|case=NOMINATIVE	
-que	que	CONJ	_	
noscantur	nosco	VB	person=PERSON_3|number=PLURAL|tense=PR|mood=SUBJUNCTIVE|voice=PASSIVE	
fuerit	sum	VB	person=PERSON_3|number=SINGULAR|tense=PERF|mood=SUBJUNCTIVE|voice=ACTIVE	
fuerit	sum	VB	person=PERSON_3|number=SINGULAR|tense=PERF|mood=SUBJUNCTIVE|voice=ACTIVE	
fuerit	sum	VB	person=PERSON_3|number=SINGULAR|tense=PERF|mood=SUBJUNCTIVE|voice=ACTIVE	
fuerit	sum	VB	person=PERSON_3|number=SINGULAR|tense=PERF|mood=SUBJUNCTIVE|voice=ACTIVE	
nam	nam	CONJ	_	
post	post	PREP	_	
conditam	condo	VB	number=SINGULAR|tense=PERF|mood=PARTICIPLE|voice=PASSIVE|gender=FEMININE|case=ACCUSATIVE	
urbem	urbs	NN	number=SINGULAR|gender=FEMININE|case=ACCUSATIVE	
octingentos	octingenti	NRL	number=PLURAL|gender=MASCULINE|case=ACCUSATIVE	
et	et	CONJ	_	
viginti	viginti	NRL	_	
prioris	prior	ADJ	number=SINGULAR|gender=NEUTER|case=GENITIVE|degree=COMPARATIVE	
aevi	aevum	NN	number=SINGULAR|gender=NEUTER|case=GENITIVE	
annos	annus	NN	number=PLURAL|gender=MASCULINE|case=ACCUSATIVE	
multi	multus	ADJ	number=PLURAL|gender=MASCULINE|case=NOMINATIVE	
auctores	auctor	NN	number=PLURAL|gender=MASCULINE|case=NOMINATIVE	
rettulerunt	refero	VB	person=PERSON_3|number=PLURAL|tense=PERF|mood=INDICATIVE|voice=ACTIVE	
dum	dum	CONJ	_	
res	res	NN	number=PLURAL|gender=FEMININE|case=NOMINATIVE	
populi	populus	NN	number=SINGULAR|gender=MASCULINE|case=GENITIVE	
Romani	Romanus	ADJ	number=SINGULAR|gender=MASCULINE|case=GENITIVE	
memorabantur	memoro	VB	person=PERSON_3|number=PLURAL|tense=IMP|mood=INDICATIVE|voice=PASSIVE	
pari	par	ADJ	number=SINGULAR|gender=FEMININE|case=ABLATIVE	
eloquentia	eloquentia	NN	number=SINGULAR|gender=FEMININE|case=ABLATIVE	
ac	atque	CONJ	_	
libertate	libertas	NN	number=SINGULAR|gender=FEMININE|case=ABLATIVE	
bis	bis	ADV	_	
et	et	CONJ	_	
viciens	viciens	ADV	_	
miliens	millies	ADV	_	
sestertium	sestertius	ADJ	number=PLURAL|gender=NEUTER|case=GENITIVE	
donationibus	donatio	NN	number=PLURAL|gender=FEMININE|case=ABLATIVE	
Nero	Nero	NN	number=SINGULAR|gender=MASCULINE|case=NOMINATIVE	
effuderat	effundo	VB	person=PERSON_3|number=SINGULAR|tense=PLUSQUAMPERFECT|mood=INDICATIVE|voice=ACTIVE	
constat	consto	VB	person=PERSON_3|number=SINGULAR|tense=PR|mood=INDICATIVE|voice=ACTIVE	
potuisse	possum	VB	tense=PERF|mood=INFINITIVE|voice=ACTIVE	
conciliari	concilio	VB	tense=PR|mood=INFINITIVE|voice=PASSIVE	
animos	animus	NN	number=PLURAL|gender=MASCULINE|case=ACCUSATIVE	
quantulacumque	quantuluscumque	ADJ	number=SINGULAR|gender=FEMININE|case=ABLATIVE	
parci	parcus	ADJ	number=SINGULAR|gender=MASCULINE|case=GENITIVE	
senis	senex	ADJ	number=SINGULAR|gender=MASCULINE|case=GENITIVE	
liberalitate	liberalitas	NN	number=SINGULAR|gender=FEMININE|case=ABLATIVE	
Africa	Africa	NN	number=SINGULAR|gender=FEMININE|case=NOMINATIVE	
ac	atque	CONJ	_	
legiones	legio	NN	number=PLURAL|gender=FEMININE|case=NOMINATIVE	
in	in	PREP	_	
ea	is	PRON	number=SINGULAR|gender=FEMININE|case=ABLATIVE	
interfecto	interficio	VB	number=SINGULAR|tense=PERF|mood=PARTICIPLE|voice=PASSIVE|gender=MASCULINE|case=ABLATIVE	
Clodio	Clodius	NN	number=SINGULAR|gender=MASCULINE|case=ABLATIVE	
Macro	Macer	NN	number=SINGULAR|gender=MASCULINE|case=ABLATIVE	
contenta	contineo	VB	number=SINGULAR|tense=PERF|mood=PARTICIPLE|voice=PASSIVE|gender=FEMININE|case=NOMINATIVE	
qualicumque	qualiscumque	PRON	number=SINGULAR|gender=MASCULINE|case=ABLATIVE	
principe	princeps	ADJ	number=SINGULAR|gender=MASCULINE|case=ABLATIVE	
post	post	PREP	_	
experimentum	experimentum	NN	number=SINGULAR|gender=NEUTER|case=ACCUSATIVE	
domini	dominus	NN	number=SINGULAR|gender=MASCULINE|case=GENITIVE	
minoris	parvus	ADJ	number=SINGULAR|gender=MASCULINE|case=GENITIVE|degree=COMPARATIVE	
ille	ille	PRON	number=SINGULAR|gender=MASCULINE|case=NOMINATIVE	
ut	ut	CONJ	_	
Nymphidii	Nymphidius	NN	number=SINGULAR|gender=MASCULINE|case=GENITIVE	
socius	socius	ADJ	number=SINGULAR|gender=MASCULINE|case=NOMINATIVE	
hic	hic	PRON	number=SINGULAR|gender=MASCULINE|case=NOMINATIVE	
ut	ut	CONJ	_	
dux	dux	NN	number=SINGULAR|gender=MASCULINE|case=NOMINATIVE	
Neronis	Nero	NN	number=SINGULAR|gender=MASCULINE|case=GENITIVE	
inauditi	inauditus	ADJ	number=PLURAL|gender=MASCULINE|case=NOMINATIVE	
atque	atque	CONJ	_	
indefensi	indefensus	ADJ	number=PLURAL|gender=MASCULINE|case=NOMINATIVE	
tamquam	tamquam	ADV	_	
innocentes	innocens	ADJ	number=PLURAL|gender=MASCULINE|case=NOMINATIVE	
perierant	pereo	VB	person=PERSON_3|number=PLURAL|tense=PLUSQUAMPERFECT|mood=INDICATIVE|voice=ACTIVE	
nec	neque	CONJ	_	
aliud	alius	ADJ	number=SINGULAR|gender=NEUTER|case=NOMINATIVE	
sequenti	sequor	VB	number=SINGULAR|tense=PR|mood=PARTICIPLE|gender=NEUTER|case=ABLATIVE	
quadriduo	quadriduum	NN	number=SINGULAR|gender=NEUTER|case=ABLATIVE	
quod	qui	PRON	number=SINGULAR|gender=NEUTER|case=NOMINATIVE	
medium	medius	ADJ	number=SINGULAR|gender=NEUTER|case=NOMINATIVE	
inter	inter	PREP	_	
adoptionem	adoptio	NN	number=SINGULAR|gender=FEMININE|case=ACCUSATIVE	
et	et	CONJ	_	
caedem	caedes	NN	number=SINGULAR|gender=FEMININE|case=ACCUSATIVE	
fuit	sum	VB	person=PERSON_3|number=SINGULAR|tense=PERF|mood=INDICATIVE|voice=ACTIVE	
dictum	dico	VB	number=SINGULAR|tense=PERF|mood=PARTICIPLE|voice=PASSIVE|gender=NEUTER|case=NOMINATIVE	
a	ab	PREP	_	
Pisone	Piso	NN	number=SINGULAR|gender=MASCULINE|case=ABLATIVE	
in	in	PREP	_	
publico	publicus	ADJ	number=SINGULAR|gender=NEUTER|case=ABLATIVE	
factum	facio	VB	number=SINGULAR|tense=PERF|mood=PARTICIPLE|voice=PASSIVE|gender=NEUTER|case=NOMINATIVE	
-ve	ve	CONJ	_	
Inde	inde	ADV	_	
apud	apud	PREP	_	
senatum	senatus	NN	number=SINGULAR|gender=MASCULINE|case=ACCUSATIVE	
non	non	ADV	_	
comptior	como	VB	number=SINGULAR|tense=PERF|mood=PARTICIPLE|voice=PASSIVE|gender=MASCULINE|case=NOMINATIVE|degree=COMPARATIVE	
Galbae	Galba	NN	number=SINGULAR|gender=MASCULINE|case=GENITIVE	
non	non	ADV	_	
longior	longus	ADJ	number=SINGULAR|gender=MASCULINE|case=NOMINATIVE|degree=COMPARATIVE	
quam	quam	ADV	_	
apud	apud	PREP	_	
militem	miles	NN	number=SINGULAR|gender=MASCULINE|case=ACCUSATIVE	
sermo	sermo	NN	number=SINGULAR|gender=MASCULINE|case=NOMINATIVE	
fuit	sum	VB	person=PERSON_3|number=SINGULAR|tense=PERF|mood=INDICATIVE|voice=ACTIVE	
fuit	sum	VB	person=PERSON_3|number=SINGULAR|tense=PERF|mood=INDICATIVE|voice=ACTIVE	
sermo	sermo	NN	number=SINGULAR|gender=MASCULINE|case=NOMINATIVE	
nec	neque	CONJ	_	
enim	enim	CONJ	_	
ad	ad	PREP	_	
hanc	hic	PRON	number=SINGULAR|gender=FEMININE|case=ACCUSATIVE	
formam	forma	NN	number=SINGULAR|gender=FEMININE|case=ACCUSATIVE	
cetera	ceterus	ADJ	number=PLURAL|gender=NEUTER|case=NOMINATIVE	
erant	sum	VB	person=PERSON_3|number=PLURAL|tense=IMP|mood=INDICATIVE|voice=ACTIVE	
is	is	PRON	number=SINGULAR|gender=MASCULINE|case=NOMINATIVE	
consilio	consilium	NN	number=SINGULAR|gender=NEUTER|case=DATIVE	
intercessit	intercedo	VB	person=PERSON_3|number=SINGULAR|tense=PERF|mood=INDICATIVE|voice=ACTIVE	
accessit	accedo	VB	person=PERSON_3|number=SINGULAR|tense=PERF|mood=INDICATIVE|voice=ACTIVE	
Galbae	Galba	NN	number=SINGULAR|gender=MASCULINE|case=GENITIVE	
vox	vox	NN	number=SINGULAR|gender=FEMININE|case=NOMINATIVE	
pro	pro	PREP	_	
re	res	NN	number=SINGULAR|gender=FEMININE|case=ABLATIVE	
publica	publicus	ADJ	number=SINGULAR|gender=FEMININE|case=ABLATIVE	
honesta	honestus	ADJ	number=SINGULAR|gender=FEMININE|case=NOMINATIVE	
ipsi	ipse	PRON	number=SINGULAR|gender=MASCULINE|case=DATIVE	
anceps	anceps	ADJ	number=SINGULAR|gender=FEMININE|case=NOMINATIVE	
legi	lego	VB	tense=PR|mood=INFINITIVE|voice=PASSIVE	
a	ab	PREP	_	
se	sui	PRON	number=SINGULAR|gender=MASCULINE|case=ABLATIVE	
militem	miles	NN	number=SINGULAR|gender=MASCULINE|case=ACCUSATIVE	
non	non	ADV	_	
emi	emo	VB	tense=PR|mood=INFINITIVE|voice=PASSIVE	
et	et	CONJ	_	
quibus	qui	PRON	number=PLURAL|gender=MASCULINE|case=DATIVE	
deerat	desum	VB	person=PERSON_3|number=SINGULAR|tense=IMP|mood=INDICATIVE|voice=ACTIVE	
inimicus	inimicus	ADJ	number=SINGULAR|gender=MASCULINE|case=NOMINATIVE	
per	per	PREP	_	
amicos	amicus	NN	number=PLURAL|gender=MASCULINE|case=ACCUSATIVE	
oppressi	opprimo	VB	number=PLURAL|tense=PERF|mood=PARTICIPLE|voice=PASSIVE|gender=MASCULINE|case=NOMINATIVE	
trina	trini	NRL	number=PLURAL|gender=NEUTER|case=NOMINATIVE	
bella	bellum	NN	number=PLURAL|gender=NEUTER|case=NOMINATIVE	
civilia	civilis	ADJ	number=PLURAL|gender=NEUTER|case=NOMINATIVE	
plura	multus	ADJ	number=PLURAL|gender=NEUTER|case=NOMINATIVE|degree=COMPARATIVE	
externa	externus	ADJ	number=PLURAL|gender=NEUTER|case=NOMINATIVE	
ac	atque	CONJ	_	
plerumque	plerusque	ADV	_	
permixta	permisceo	VB	number=PLURAL|tense=PERF|mood=PARTICIPLE|voice=PASSIVE|gender=NEUTER|case=NOMINATIVE	
fuerunt	sum	VB	person=PERSON_3|number=PLURAL|tense=PERF|mood=INDICATIVE|voice=ACTIVE	
palam	palam	ADV	_	
laudares	laudo	VB	person=PERSON_2|number=SINGULAR|tense=IMP|mood=SUBJUNCTIVE|voice=ACTIVE	
secreta	secerno	VB	number=PLURAL|tense=PERF|mood=PARTICIPLE|voice=PASSIVE|gender=NEUTER|case=NOMINATIVE	
male	malus	ADV	_	
audiebant	audio	VB	person=PERSON_3|number=PLURAL|tense=IMP|mood=INDICATIVE|voice=ACTIVE	
Piso	Piso	NN	number=SINGULAR|gender=MASCULINE|case=NOMINATIVE	
M.	Marcus	NN	number=SINGULAR|gender=MASCULINE|case=ABLATIVE	
Crasso	Crassus	NN	number=SINGULAR|gender=MASCULINE|case=ABLATIVE	
et	et	CONJ	_	
Scribonia	Scribonia	NN	number=SINGULAR|gender=FEMININE|case=ABLATIVE	
genitus	gigno	VB	number=SINGULAR|tense=PERF|mood=PARTICIPLE|voice=PASSIVE|gender=MASCULINE|case=NOMINATIVE	
nobilis	nobilis	ADJ	number=SINGULAR|gender=MASCULINE|case=NOMINATIVE	
utrimque	utrimque	ADV	_	
vultu	vultus	NN	number=SINGULAR|gender=MASCULINE|case=ABLATIVE	
habitu	habitus	NN	number=SINGULAR|gender=MASCULINE|case=ABLATIVE	
-que	que	CONJ	_	
moris	mos	NN	number=SINGULAR|gender=MASCULINE|case=GENITIVE	
antiqui	antiquus	ADJ	number=SINGULAR|gender=MASCULINE|case=GENITIVE	
et	et	CONJ	_	
aestimatione	aestimatio	NN	number=SINGULAR|gender=FEMININE|case=ABLATIVE	
recta	rego	VB	number=SINGULAR|tense=PERF|mood=PARTICIPLE|voice=PASSIVE|gender=FEMININE|case=ABLATIVE	
severus	severus	ADJ	number=SINGULAR|gender=MASCULINE|case=NOMINATIVE	
deterius	deterior	ADV	degree=COMPARATIVE	
interpretantibus	interpretor	VB	number=PLURAL|tense=PR|mood=PARTICIPLE|gender=MASCULINE|case=ABLATIVE	
tristior	tristis	ADJ	number=SINGULAR|gender=MASCULINE|case=NOMINATIVE|degree=COMPARATIVE	
habebatur	habeo	VB	person=PERSON_3|number=SINGULAR|tense=IMP|mood=INDICATIVE|voice=PASSIVE	
habebatur	habeo	VB	person=PERSON_3|number=SINGULAR|tense=IMP|mood=INDICATIVE|voice=PASSIVE	
regebat	rego	VB	person=PERSON_3|number=SINGULAR|tense=IMP|mood=INDICATIVE|voice=ACTIVE	
tum	tum	ADV	_	
Tiberius	Tiberius	NN	number=SINGULAR|gender=MASCULINE|case=NOMINATIVE	
Alexander	Alexander	NN	number=SINGULAR|gender=MASCULINE|case=NOMINATIVE	
eiusdem	idem	PRON	number=SINGULAR|gender=FEMININE|case=GENITIVE	
nationis	natio	NN	number=SINGULAR|gender=FEMININE|case=GENITIVE	
ne	ne	ADV	_	
ipse	ipse	PRON	number=SINGULAR|gender=MASCULINE|case=NOMINATIVE	
quidem	quidem	ADV	_	
ad	ad	PREP	_	
securas	securus	ADJ	number=PLURAL|gender=FEMININE|case=ACCUSATIVE	
res	res	NN	number=PLURAL|gender=FEMININE|case=ACCUSATIVE	
accessi	accedo	VB	person=PERSON_1|number=SINGULAR|tense=PERF|mood=INDICATIVE|voice=ACTIVE	
et	et	CONJ	_	
audita	audio	VB	number=SINGULAR|tense=PERF|mood=PARTICIPLE|voice=PASSIVE|gender=FEMININE|case=ABLATIVE	
adoptione	adoptio	NN	number=SINGULAR|gender=FEMININE|case=ABLATIVE	
desinam	desino	VB	person=PERSON_1|number=SINGULAR|tense=FUTURE|mood=INDICATIVE|voice=ACTIVE	
videri	video	VB	tense=PR|mood=INFINITIVE|voice=PASSIVE	
senex	senex	ADJ	number=SINGULAR|gender=MASCULINE|case=NOMINATIVE	
quod	qui	PRON	number=SINGULAR|gender=NEUTER|case=NOMINATIVE	
nunc	nunc	ADV	_	
mihi	ego	PRON	number=SINGULAR|gender=MASCULINE|case=DATIVE	
unum	unus	NRL	number=SINGULAR|gender=NEUTER|case=NOMINATIVE	
obicitur	obicio	VB	person=PERSON_3|number=SINGULAR|tense=PR|mood=INDICATIVE|voice=PASSIVE	
at	at	CONJ	_	
illis	ille	PRON	number=PLURAL|gender=MASCULINE|case=DATIVE	
vix	vix	ADV	_	
decimae	decimus	NRL	number=PLURAL|gender=FEMININE|case=NOMINATIVE	
super	super	PREP	_	
portiones	portio	NN	number=PLURAL|gender=FEMININE|case=ACCUSATIVE	
erant	sum	VB	person=PERSON_3|number=PLURAL|tense=IMP|mood=INDICATIVE|voice=ACTIVE	
isdem	idem	PRON	number=PLURAL|gender=MASCULINE|case=ABLATIVE	
erga	erga	PREP	_	
aliena	alienus	ADJ	number=PLURAL|gender=NEUTER|case=ACCUSATIVE	
sumptibus	sumptus	NN	number=PLURAL|gender=MASCULINE|case=ABLATIVE	
quibus	qui	PRON	number=PLURAL|gender=NEUTER|case=ABLATIVE	
sua	suus	PRON	number=PLURAL|gender=NEUTER|case=ACCUSATIVE	
prodegerant	prodigo	VB	person=PERSON_3|number=PLURAL|tense=PLUSQUAMPERFECT|mood=INDICATIVE|voice=ACTIVE	
cum	cum	CONJ	_	
rapacissimo	rapax	ADJ	number=SINGULAR|gender=MASCULINE|case=DATIVE|degree=SUPERLATIVE	
cuique	quisque	PRON	number=SINGULAR|gender=MASCULINE|case=DATIVE	
ac	atque	CONJ	_	
perditissimo	perdo	VB	number=SINGULAR|tense=PERF|mood=PARTICIPLE|voice=PASSIVE|gender=MASCULINE|case=DATIVE|degree=SUPERLATIVE	
non	non	ADV	_	
agri	ager	NN	number=PLURAL|gender=MASCULINE|case=NOMINATIVE	
aut	aut	CONJ	_	
faenus	faenus	NN	number=SINGULAR|gender=NEUTER|case=NOMINATIVE	
sed	sed	CONJ	_	
sola	solus	ADJ	number=PLURAL|gender=NEUTER|case=NOMINATIVE	
instrumenta	instrumentum	NN	number=PLURAL|gender=NEUTER|case=NOMINATIVE	
vitiorum	vitium	NN	number=PLURAL|gender=NEUTER|case=GENITIVE	
manerent	maneo	VB	person=PERSON_3|number=PLURAL|tense=IMP|mood=SUBJUNCTIVE|voice=ACTIVE	
prosperae	prosper	ADJ	number=PLURAL|gender=FEMININE|case=NOMINATIVE	
in	in	PREP	_	
Oriente	orior	VB	number=SINGULAR|tense=PR|mood=PARTICIPLE|gender=MASCULINE|case=ABLATIVE	
adversae	adverto	VB	number=PLURAL|tense=PERF|mood=PARTICIPLE|voice=PASSIVE|gender=FEMININE|case=NOMINATIVE	
in	in	PREP	_	
Occidente	occido	VB	number=SINGULAR|tense=PR|mood=PARTICIPLE|gender=MASCULINE|case=ABLATIVE	
res	res	NN	number=PLURAL|gender=FEMININE|case=NOMINATIVE	
fuerunt	sum	VB	person=PERSON_3|number=PLURAL|tense=PERF|mood=INDICATIVE|voice=ACTIVE	
fuerunt	sum	VB	person=PERSON_3|number=PLURAL|tense=PERF|mood=INDICATIVE|voice=ACTIVE	
Paucis	paucus	ADJ	number=PLURAL|gender=MASCULINE|case=ABLATIVE	
post	post	PREP	_	
kalendas	Kalendae	NN	number=PLURAL|gender=FEMININE|case=ACCUSATIVE	
Ianuarias	Januarius	ADJ	number=PLURAL|gender=FEMININE|case=ACCUSATIVE	
diebus	dies	NN	number=PLURAL|gender=MASCULINE|case=ABLATIVE	
Pompei	Pompejus	NN	number=SINGULAR|gender=MASCULINE|case=GENITIVE	
Propinqui	Propinquus	NN	number=SINGULAR|gender=MASCULINE|case=GENITIVE	
procuratoris	procurator	NN	number=SINGULAR|gender=MASCULINE|case=GENITIVE	
e	ex	PREP	_	
Belgica	Belgicus	ADJ	number=SINGULAR|gender=FEMININE|case=ABLATIVE	
litterae	littera	NN	number=PLURAL|gender=FEMININE|case=NOMINATIVE	
adferuntur	affero	VB	person=PERSON_3|number=PLURAL|tense=PR|mood=INDICATIVE|voice=PASSIVE	
superioris	superus	ADJ	number=SINGULAR|gender=FEMININE|case=GENITIVE|degree=COMPARATIVE	
Germaniae	Germania	NN	number=SINGULAR|gender=FEMININE|case=GENITIVE	
legiones	legio	NN	number=PLURAL|gender=FEMININE|case=ACCUSATIVE	
rupta	rumpo	VB	number=SINGULAR|tense=PERF|mood=PARTICIPLE|voice=PASSIVE|gender=FEMININE|case=ABLATIVE	
sacramenti	sacramentum	NN	number=SINGULAR|gender=NEUTER|case=GENITIVE	
reverentia	reverentia	NN	number=SINGULAR|gender=FEMININE|case=ABLATIVE	
imperatorem	imperator	NN	number=SINGULAR|gender=MASCULINE|case=ACCUSATIVE	
alium	alius	ADJ	number=SINGULAR|gender=MASCULINE|case=ACCUSATIVE	
flagitare	flagito	VB	tense=PR|mood=INFINITIVE|voice=ACTIVE	
et	et	CONJ	_	
senatui	senatus	NN	number=SINGULAR|gender=MASCULINE|case=DATIVE	
ac	atque	CONJ	_	
populo	populus	NN	number=SINGULAR|gender=MASCULINE|case=DATIVE	
Romano	Romanus	ADJ	number=SINGULAR|gender=MASCULINE|case=DATIVE	
arbitrium	arbitrium	NN	number=SINGULAR|gender=NEUTER|case=ACCUSATIVE	
eligendi	eligo	VB	mood=GERUNDIVE|case=GENITIVE	
permittere	permitto	VB	tense=PR|mood=INFINITIVE|voice=ACTIVE	
quo	quo	ADV	_	
seditio	seditio	NN	number=SINGULAR|gender=FEMININE|case=NOMINATIVE	
mollius	mollis	ADV	degree=COMPARATIVE	
acciperetur	accipio	VB	person=PERSON_3|number=SINGULAR|tense=IMP|mood=SUBJUNCTIVE|voice=PASSIVE	
ita	ita	ADV	_	
visum	video	VB	number=SINGULAR|tense=PERF|mood=PARTICIPLE|voice=PASSIVE|gender=NEUTER|case=NOMINATIVE	
expedire	expedio	VB	tense=PR|mood=INFINITIVE|voice=ACTIVE	
provinciam	provincia	NN	number=SINGULAR|gender=FEMININE|case=ACCUSATIVE	
aditu	adeo	VB	mood=SUBJUNCTIVE|voice=PASSIVE	
difficilem	difficilis	ADJ	number=SINGULAR|gender=FEMININE|case=ACCUSATIVE	
annonae	annona	NN	number=SINGULAR|gender=FEMININE|case=GENITIVE	
fecundam	fecundus	ADJ	number=SINGULAR|gender=FEMININE|case=ACCUSATIVE	
superstitione	superstitio	NN	number=SINGULAR|gender=FEMININE|case=ABLATIVE	
ac	atque	CONJ	_	
lascivia	lascivia	NN	number=SINGULAR|gender=FEMININE|case=ABLATIVE	
discordem	discors	ADJ	number=SINGULAR|gender=FEMININE|case=ACCUSATIVE	
et	et	CONJ	_	
mobilem	mobilis	ADJ	number=SINGULAR|gender=FEMININE|case=ACCUSATIVE	
insciam	inscius	ADJ	number=SINGULAR|gender=FEMININE|case=ACCUSATIVE	
legum	lex	NN	number=PLURAL|gender=FEMININE|case=GENITIVE	
ignaram	ignarus	ADJ	number=SINGULAR|gender=FEMININE|case=ACCUSATIVE	
magistratuum	magistratus	NN	number=PLURAL|gender=MASCULINE|case=GENITIVE	
domi	domus	NN	number=SINGULAR|gender=FEMININE|case=GENITIVE	
retinere	retineo	VB	tense=PR|mood=INFINITIVE|voice=ACTIVE	
Si	si	CONJ	_	
immensum	immensus	ADJ	number=SINGULAR|gender=NEUTER|case=NOMINATIVE	
imperii	imperium	NN	number=SINGULAR|gender=NEUTER|case=GENITIVE	
corpus	corpus	NN	number=SINGULAR|gender=NEUTER|case=NOMINATIVE	
stare	sto	VB	tense=PR|mood=INFINITIVE|voice=ACTIVE	
ac	atque	CONJ	_	
librari	libro	VB	tense=PR|mood=INFINITIVE|voice=PASSIVE	
sine	sine	PREP	_	
rectore	rector	NN	number=SINGULAR|gender=MASCULINE|case=ABLATIVE	
posset	possum	VB	person=PERSON_3|number=SINGULAR|tense=IMP|mood=SUBJUNCTIVE|voice=ACTIVE	
dignus	dignus	ADJ	number=SINGULAR|gender=MASCULINE|case=NOMINATIVE	
eram	sum	VB	person=PERSON_1|number=SINGULAR|tense=IMP|mood=INDICATIVE|voice=ACTIVE	
a	ab	PREP	_	
quo	qui	PRON	number=SINGULAR|gender=MASCULINE|case=ABLATIVE	
res	res	NN	number=SINGULAR|gender=FEMININE|case=NOMINATIVE	
publica	publicus	ADJ	number=SINGULAR|gender=FEMININE|case=NOMINATIVE	
inciperet	incipio	VB	person=PERSON_3|number=SINGULAR|tense=IMP|mood=SUBJUNCTIVE|voice=ACTIVE	
quies	quies	NN	number=SINGULAR|gender=FEMININE|case=NOMINATIVE	
et	et	CONJ	_	
Illyrico	Illyricum	NN	number=SINGULAR|gender=NEUTER|case=ABLATIVE	
quamquam	quamquam	CONJ	_	
excitae	excio	VB	number=PLURAL|tense=PERF|mood=PARTICIPLE|voice=PASSIVE|gender=FEMININE|case=NOMINATIVE	
a	ab	PREP	_	
Nerone	Nero	NN	number=SINGULAR|gender=MASCULINE|case=ABLATIVE	
legiones	legio	NN	number=PLURAL|gender=FEMININE|case=NOMINATIVE	
dum	dum	CONJ	_	
in	in	PREP	_	
Italia	Italia	NN	number=SINGULAR|gender=FEMININE|case=ABLATIVE	
cunctantur	cunctor	VB	person=PERSON_3|number=PLURAL|tense=PR|mood=INDICATIVE|voice=DEPONENS	
Verginium	Verginius	NN	number=SINGULAR|gender=MASCULINE|case=ACCUSATIVE	
legationibus	legatio	NN	number=PLURAL|gender=FEMININE|case=ABLATIVE	
adissent	adeo	VB	person=PERSON_3|number=PLURAL|tense=PLUSQUAMPERFECT|mood=SUBJUNCTIVE|voice=ACTIVE	
fuit	sum	VB	person=PERSON_3|number=SINGULAR|tense=PERF|mood=INDICATIVE|voice=ACTIVE	
eo	is	PRON	number=SINGULAR|gender=MASCULINE|case=ABLATIVE	
-que	que	CONJ	_	
Poppaeam	Poppaea	NN	number=SINGULAR|gender=FEMININE|case=ACCUSATIVE	
Sabinam	Sabina	NN	number=SINGULAR|gender=FEMININE|case=ACCUSATIVE	
principale	principalis	ADJ	number=SINGULAR|gender=NEUTER|case=ACCUSATIVE	
scortum	scortum	NN	number=SINGULAR|gender=NEUTER|case=ACCUSATIVE	
ut	ut	CONJ	_	
apud	apud	PREP	_	
conscium	conscius	ADJ	number=SINGULAR|gender=MASCULINE|case=ACCUSATIVE	
libidinum	libido	NN	number=PLURAL|gender=FEMININE|case=GENITIVE	
deposuerat	depono	VB	person=PERSON_3|number=SINGULAR|tense=PLUSQUAMPERFECT|mood=INDICATIVE|voice=ACTIVE	
donec	donec	CONJ	_	
Octaviam	Octavia	NN	number=SINGULAR|gender=FEMININE|case=ACCUSATIVE	
uxorem	uxor	NN	number=SINGULAR|gender=FEMININE|case=ACCUSATIVE	
amoliretur	amolior	VB	person=PERSON_3|number=SINGULAR|tense=IMP|mood=SUBJUNCTIVE|voice=DEPONENS	
fortunam	fortuna	NN	number=SINGULAR|gender=FEMININE|case=ACCUSATIVE	
adhuc	adhuc	ADV	_	
tantum	tantus	ADV	_	
adversam	adverto	VB	number=SINGULAR|tense=PERF|mood=PARTICIPLE|voice=PASSIVE|gender=FEMININE|case=ACCUSATIVE	
tulisti	fero	VB	person=PERSON_2|number=SINGULAR|tense=PERF|mood=INDICATIVE|voice=ACTIVE	
propinqui	propinquus	ADJ	number=PLURAL|gender=MASCULINE|case=NOMINATIVE	
audentes	audeo	VB	number=PLURAL|tense=PR|mood=PARTICIPLE|gender=MASCULINE|case=NOMINATIVE	
constantes	consto	VB	number=PLURAL|tense=PR|mood=PARTICIPLE|gender=MASCULINE|case=NOMINATIVE	
generi	gener	NN	number=PLURAL|gender=MASCULINE|case=NOMINATIVE	
contumax	contumax	ADJ	number=SINGULAR|gender=FEMININE|case=NOMINATIVE	
etiam	etiam	CONJ	_	
adversus	adversus	PREP	_	
tormenta	tormentum	NN	number=PLURAL|gender=NEUTER|case=ACCUSATIVE	
servorum	servus	NN	number=PLURAL|gender=MASCULINE|case=GENITIVE	
fides	fides	NN	number=SINGULAR|gender=FEMININE|case=NOMINATIVE	
fuit	sum	VB	person=PERSON_3|number=SINGULAR|tense=PERF|mood=INDICATIVE|voice=ACTIVE	
fuerunt	sum	VB	person=PERSON_3|number=PLURAL|tense=PERF|mood=INDICATIVE|voice=ACTIVE	
fuerunt	sum	VB	person=PERSON_3|number=PLURAL|tense=PERF|mood=INDICATIVE|voice=ACTIVE	
sed	sed	CONJ	_	
patres	pater	NN	number=PLURAL|gender=MASCULINE|case=NOMINATIVE	
laeti	laetus	ADJ	number=PLURAL|gender=MASCULINE|case=NOMINATIVE	
usurpata	usurpo	VB	number=SINGULAR|tense=PERF|mood=PARTICIPLE|voice=PASSIVE|gender=FEMININE|case=ABLATIVE	
statim	statim	ADV	_	
libertate	libertas	NN	number=SINGULAR|gender=FEMININE|case=ABLATIVE	
licentius	licet	ADV	degree=COMPARATIVE	
ut	ut	CONJ	_	
erga	erga	PREP	_	
principem	princeps	ADJ	number=SINGULAR|gender=MASCULINE|case=ACCUSATIVE	
novum	novus	ADJ	number=SINGULAR|gender=MASCULINE|case=ACCUSATIVE	
et	et	CONJ	_	
absentem	absum	VB	number=SINGULAR|tense=PR|mood=PARTICIPLE|gender=MASCULINE|case=ACCUSATIVE	
fuerunt	sum	VB	person=PERSON_3|number=PLURAL|tense=PERF|mood=INDICATIVE|voice=ACTIVE	
usurpata	usurpo	VB	number=SINGULAR|tense=PERF|mood=PARTICIPLE|voice=PASSIVE|gender=FEMININE|case=NOMINATIVE	
Interea	interea	ADV	_	
Othonem	Otho	NN	number=SINGULAR|gender=MASCULINE|case=ACCUSATIVE	
cui	qui	PRON	number=SINGULAR|gender=MASCULINE|case=DATIVE	
compositis	compono	VB	number=PLURAL|tense=PERF|mood=PARTICIPLE|voice=PASSIVE|gender=FEMININE|case=ABLATIVE	
rebus	res	NN	number=PLURAL|gender=FEMININE|case=ABLATIVE	
nulla	nullus	ADJ	number=SINGULAR|gender=FEMININE|case=NOMINATIVE	
spes	spes	NN	number=SINGULAR|gender=FEMININE|case=NOMINATIVE	
omne	omnis	ADJ	number=SINGULAR|gender=NEUTER|case=NOMINATIVE	
in	in	PREP	_	
turbido	turbidus	ADJ	number=SINGULAR|gender=NEUTER|case=ABLATIVE	
consilium	consilium	NN	number=SINGULAR|gender=NEUTER|case=NOMINATIVE	
multa	multus	ADJ	number=PLURAL|gender=NEUTER|case=NOMINATIVE	
simul	simul	ADV	_	
extimulabant	exstimulo	VB	person=PERSON_3|number=PLURAL|tense=IMP|mood=INDICATIVE|voice=ACTIVE	
luxuria	luxuria	NN	number=SINGULAR|gender=FEMININE|case=NOMINATIVE	
etiam	etiam	CONJ	_	
principi	princeps	ADJ	number=SINGULAR|gender=MASCULINE|case=DATIVE	
onerosa	onerosus	ADJ	number=SINGULAR|gender=FEMININE|case=NOMINATIVE	
inopia	inopia	NN	number=SINGULAR|gender=FEMININE|case=NOMINATIVE	
vix	vix	ADV	_	
privato	privo	ADV	_	
toleranda	tolero	VB	number=SINGULAR|mood=GERUNDIVE|gender=FEMININE|case=NOMINATIVE	
in	in	PREP	_	
Galbam	Galba	NN	number=SINGULAR|gender=MASCULINE|case=ACCUSATIVE	
ira	ira	NN	number=SINGULAR|gender=FEMININE|case=NOMINATIVE	
in	in	PREP	_	
Pisonem	Piso	NN	number=SINGULAR|gender=MASCULINE|case=ACCUSATIVE	
invidia	invidia	NN	number=SINGULAR|gender=FEMININE|case=NOMINATIVE	
fuit	sum	VB	person=PERSON_3|number=SINGULAR|tense=PERF|mood=INDICATIVE|voice=ACTIVE	
fuit	sum	VB	person=PERSON_3|number=SINGULAR|tense=PERF|mood=INDICATIVE|voice=ACTIVE	
nocuit	noceo	VB	person=PERSON_3|number=SINGULAR|tense=PERF|mood=INDICATIVE|voice=ACTIVE	
antiquus	antiquus	ADJ	number=SINGULAR|gender=MASCULINE|case=NOMINATIVE	
rigor	rigor	NN	number=SINGULAR|gender=MASCULINE|case=NOMINATIVE	
et	et	CONJ	_	
nimia	nimius	ADJ	number=SINGULAR|gender=FEMININE|case=NOMINATIVE	
severitas	severitas	NN	number=SINGULAR|gender=FEMININE|case=NOMINATIVE	
cui	qui	PRON	number=SINGULAR|gender=FEMININE|case=DATIVE	
iam	jam	ADV	_	
pares	par	ADJ	number=PLURAL|gender=MASCULINE|case=NOMINATIVE	
non	non	ADV	_	
sumus	sum	VB	person=PERSON_1|number=PLURAL|tense=PR|mood=INDICATIVE|voice=ACTIVE	
primores	primoris	ADJ	number=PLURAL|gender=MASCULINE|case=NOMINATIVE	
equitum	eques	NN	number=PLURAL|gender=MASCULINE|case=GENITIVE	
proximi	propior	ADJ	number=PLURAL|gender=MASCULINE|case=NOMINATIVE|degree=SUPERLATIVE	
gaudio	gaudium	NN	number=SINGULAR|gender=NEUTER|case=DATIVE	
patrum	pater	NN	number=PLURAL|gender=MASCULINE|case=GENITIVE	
fuerunt	sum	VB	person=PERSON_3|number=PLURAL|tense=PERF|mood=INDICATIVE|voice=ACTIVE	
ac	atque	CONJ	_	
ne	ne	ADV	_	
dissimulata	dissimulo	VB	number=SINGULAR|tense=PERF|mood=PARTICIPLE|voice=PASSIVE|gender=FEMININE|case=NOMINATIVE	
seditio	seditio	NN	number=SINGULAR|gender=FEMININE|case=NOMINATIVE	
in	in	PREP	_	
maius	magnus	ADJ	number=SINGULAR|gender=NEUTER|case=ACCUSATIVE|degree=COMPARATIVE	
crederetur	credo	VB	person=PERSON_3|number=SINGULAR|tense=IMP|mood=SUBJUNCTIVE|voice=PASSIVE	
ultro	ultro	ADV	_	
adseverat	assevero	VB	person=PERSON_3|number=SINGULAR|tense=PR|mood=INDICATIVE|voice=ACTIVE	
quartam	quartus	NRL	number=SINGULAR|gender=FEMININE|case=ACCUSATIVE	
et	et	CONJ	_	
duoetvicensimam	duoetvicensimus	NRL	number=SINGULAR|gender=FEMININE|case=ACCUSATIVE	
legiones	legio	NN	number=PLURAL|gender=FEMININE|case=ACCUSATIVE	
paucis	paucus	ADJ	number=PLURAL|gender=MASCULINE|case=ABLATIVE	
seditionis	seditio	NN	number=SINGULAR|gender=FEMININE|case=GENITIVE	
auctoribus	auctor	NN	number=PLURAL|gender=MASCULINE|case=ABLATIVE	
non	non	ADV	_	
ultra	ultra	PREP	_	
verba	verbum	NN	number=PLURAL|gender=NEUTER|case=ACCUSATIVE	
ac	atque	CONJ	_	
voces	vox	NN	number=PLURAL|gender=FEMININE|case=ACCUSATIVE	
errasse	erro	VB	tense=PERF|mood=INFINITIVE|voice=ACTIVE	
et	et	CONJ	_	
brevi	brevis	ADJ	number=SINGULAR|gender=NEUTER|case=ABLATIVE	
in	in	PREP	_	
officio	officium	NN	number=SINGULAR|gender=NEUTER|case=ABLATIVE	
fore	sum	VB	tense=FUTURE|mood=INFINITIVE|voice=ACTIVE	
utilissimus	utilis	ADJ	number=SINGULAR|gender=MASCULINE|case=NOMINATIVE|degree=SUPERLATIVE	
idem	idem	PRON	number=SINGULAR|gender=MASCULINE|case=NOMINATIVE	
ac	atque	CONJ	_	
brevissimus	brevis	ADJ	number=SINGULAR|gender=MASCULINE|case=NOMINATIVE|degree=SUPERLATIVE	
bonarum	bonus	ADJ	number=PLURAL|gender=FEMININE|case=GENITIVE	
malarum	malus	ADJ	number=PLURAL|gender=FEMININE|case=GENITIVE	
-que	que	CONJ	_	
rerum	res	NN	number=PLURAL|gender=FEMININE|case=GENITIVE	
dilectus	delectus	NN	number=SINGULAR|gender=MASCULINE|case=NOMINATIVE	
est	sum	VB	person=PERSON_3|number=SINGULAR|tense=PR|mood=INDICATIVE|voice=ACTIVE	
cogitare	cogito	VB	tense=PR|mood=INFINITIVE|voice=ACTIVE	
quid	quis	PRON	number=SINGULAR|gender=NEUTER|case=ACCUSATIVE	
aut	aut	CONJ	_	
volueris	volo	VB	person=PERSON_2|number=SINGULAR|tense=PERF|mood=SUBJUNCTIVE|voice=ACTIVE	
sub	sub	PREP	_	
alio	alius	ADJ	number=SINGULAR|gender=MASCULINE|case=ABLATIVE	
principe	princeps	ADJ	number=SINGULAR|gender=MASCULINE|case=ABLATIVE	
aut	aut	CONJ	_	
nolueris	nolo	VB	person=PERSON_2|number=SINGULAR|tense=PERF|mood=SUBJUNCTIVE|voice=ACTIVE	
introitus	introitus	NN	number=SINGULAR|gender=MASCULINE|case=NOMINATIVE	
in	in	PREP	_	
urbem	urbs	NN	number=SINGULAR|gender=FEMININE|case=ACCUSATIVE	
trucidatis	trucido	VB	number=PLURAL|tense=PERF|mood=PARTICIPLE|voice=PASSIVE|gender=NEUTER|case=ABLATIVE	
tot	tot	NRL	_	
milibus	mille	NRL	number=PLURAL|gender=NEUTER|case=ABLATIVE	
inermium	inermis	ADJ	number=PLURAL|gender=MASCULINE|case=GENITIVE	
militum	miles	NN	number=PLURAL|gender=MASCULINE|case=GENITIVE	
infaustus	infaustus	ADJ	number=SINGULAR|gender=MASCULINE|case=NOMINATIVE	
omine	omen	NN	number=SINGULAR|gender=NEUTER|case=ABLATIVE	
atque	atque	CONJ	_	
ipsis	ipse	PRON	number=PLURAL|gender=MASCULINE|case=DATIVE	
etiam	etiam	CONJ	_	
qui	qui	PRON	number=PLURAL|gender=MASCULINE|case=NOMINATIVE	
occiderant	occido	VB	person=PERSON_3|number=PLURAL|tense=PLUSQUAMPERFECT|mood=INDICATIVE|voice=ACTIVE	
formidolosus	formidulosus	ADJ	number=SINGULAR|gender=MASCULINE|case=NOMINATIVE	
fuit	sum	VB	person=PERSON_3|number=SINGULAR|tense=PERF|mood=INDICATIVE|voice=ACTIVE	
fuit	sum	VB	person=PERSON_3|number=SINGULAR|tense=PERF|mood=INDICATIVE|voice=ACTIVE	
agitatum	agito	VB	number=SINGULAR|tense=PERF|mood=PARTICIPLE|voice=PASSIVE|gender=NEUTER|case=NOMINATIVE	
secreto	secerno	VB	number=SINGULAR|tense=PERF|mood=PARTICIPLE|voice=PASSIVE|gender=NEUTER|case=ABLATIVE	
num	num	ADV	_	
et	et	CONJ	_	
Piso	Piso	NN	number=SINGULAR|gender=MASCULINE|case=NOMINATIVE	
proficisceretur	proficiscor	VB	person=PERSON_3|number=SINGULAR|tense=IMP|mood=SUBJUNCTIVE|voice=DEPONENS	
maiore	magnus	ADJ	number=SINGULAR|gender=MASCULINE|case=ABLATIVE|degree=COMPARATIVE	
praetextu	praetextus	NN	number=SINGULAR|gender=MASCULINE|case=ABLATIVE	
illi	ille	PRON	number=PLURAL|gender=MASCULINE|case=NOMINATIVE	
auctoritatem	auctoritas	NN	number=SINGULAR|gender=FEMININE|case=ACCUSATIVE	
senatus	senatus	NN	number=SINGULAR|gender=MASCULINE|case=GENITIVE	
hic	hic	PRON	number=SINGULAR|gender=MASCULINE|case=NOMINATIVE	
dignationem	dignatio	NN	number=SINGULAR|gender=FEMININE|case=ACCUSATIVE	
Caesaris	Caesar	NN	number=SINGULAR|gender=MASCULINE|case=GENITIVE	
laturus	fero	VB	number=SINGULAR|tense=FUTURE|mood=PARTICIPLE|voice=ACTIVE|gender=MASCULINE|case=NOMINATIVE	
laturi	fero	VB	number=PLURAL|tense=FUTURE|mood=PARTICIPLE|voice=ACTIVE|gender=MASCULINE|case=NOMINATIVE	
nihil	nihil	NN	number=SINGULAR|gender=NEUTER	
in	in	PREP	_	
vultu	vultus	NN	number=SINGULAR|gender=MASCULINE|case=ABLATIVE	
habitu	habitus	NN	number=SINGULAR|gender=MASCULINE|case=ABLATIVE	
-que	que	CONJ	_	
mutatum	muto	VB	number=SINGULAR|tense=PERF|mood=PARTICIPLE|voice=PASSIVE|gender=NEUTER|case=NOMINATIVE	
quasi	quasi	ADV	_	
imperare	impero	VB	tense=PR|mood=INFINITIVE|voice=ACTIVE	
posset	possum	VB	person=PERSON_3|number=SINGULAR|tense=IMP|mood=SUBJUNCTIVE|voice=ACTIVE	
magis	magnus	ADV	degree=COMPARATIVE	
quam	quam	ADV	_	
vellet	volo	VB	person=PERSON_3|number=SINGULAR|tense=IMP|mood=SUBJUNCTIVE|voice=ACTIVE	
sermo	sermo	NN	number=SINGULAR|gender=MASCULINE|case=NOMINATIVE	
erga	erga	PREP	_	
patrem	pater	NN	number=SINGULAR|gender=MASCULINE|case=ACCUSATIVE	
imperatorem	imperator	NN	number=SINGULAR|gender=MASCULINE|case=ACCUSATIVE	
-que	que	CONJ	_	
reverens	revereor	VB	number=SINGULAR|tense=PR|mood=PARTICIPLE|gender=MASCULINE|case=NOMINATIVE	
de	de	PREP	_	
se	sui	PRON	number=SINGULAR|gender=MASCULINE|case=ABLATIVE	
moderatus	moderor	VB	number=SINGULAR|tense=PERF|mood=PARTICIPLE|voice=DEPONENS|gender=MASCULINE|case=NOMINATIVE	
fuit	sum	VB	person=PERSON_3|number=SINGULAR|tense=PERF|mood=INDICATIVE|voice=ACTIVE	
luxuria	luxuria	NN	number=SINGULAR|gender=FEMININE|case=ABLATIVE	
industria	industria	NN	number=SINGULAR|gender=FEMININE|case=ABLATIVE	
comitate	comitas	NN	number=SINGULAR|gender=FEMININE|case=ABLATIVE	
adrogantia	arrogantia	NN	number=SINGULAR|gender=FEMININE|case=ABLATIVE	
malis	malus	ADJ	number=PLURAL|gender=FEMININE|case=ABLATIVE	
bonis	bonus	ADJ	number=PLURAL|gender=FEMININE|case=ABLATIVE	
-que	que	CONJ	_	
artibus	ars	NN	number=PLURAL|gender=FEMININE|case=ABLATIVE	
mixtus	misceo	VB	number=SINGULAR|tense=PERF|mood=PARTICIPLE|voice=PASSIVE|gender=MASCULINE|case=NOMINATIVE	
simul	simul	ADV	_	
veritas	veritas	NN	number=SINGULAR|gender=FEMININE|case=NOMINATIVE	
pluribus	multus	ADJ	number=PLURAL|gender=MASCULINE|case=ABLATIVE|degree=COMPARATIVE	
modis	modus	NN	number=PLURAL|gender=MASCULINE|case=ABLATIVE	
infracta	infringo	VB	number=SINGULAR|tense=PERF|mood=PARTICIPLE|voice=PASSIVE|gender=FEMININE|case=NOMINATIVE	
primum	primus	ADV	_	
inscitia	inscitia	NN	number=SINGULAR|gender=FEMININE|case=ABLATIVE	
rei	res	NN	number=SINGULAR|gender=FEMININE|case=GENITIVE	
publicae	publicus	ADJ	number=SINGULAR|gender=FEMININE|case=GENITIVE	
ut	ut	CONJ	_	
alienae	alienus	ADJ	number=SINGULAR|gender=FEMININE|case=GENITIVE	
mox	mox	ADV	_	
libidine	libido	NN	number=SINGULAR|gender=FEMININE|case=ABLATIVE	
adsentandi	assentor	VB	mood=GERUND	
aut	aut	CONJ	_	
rursus	rursus	ADV	_	
odio	odium	NN	number=SINGULAR|gender=NEUTER|case=ABLATIVE	
adversus	adversus	PREP	_	
dominantis	dominor	VB	number=PLURAL|tense=PR|mood=PARTICIPLE|gender=MASCULINE|case=ACCUSATIVE	
Nero	Nero	NN	number=SINGULAR|gender=MASCULINE|case=NOMINATIVE	
a	ab	PREP	_	
pessimo	malus	ADJ	number=SINGULAR|gender=MASCULINE|case=ABLATIVE|degree=SUPERLATIVE	
quoque	quisque	PRON	number=SINGULAR|gender=MASCULINE|case=ABLATIVE	
semper	semper	ADV	_	
desiderabitur	desidero	VB	person=PERSON_3|number=SINGULAR|tense=FUTURE|mood=INDICATIVE|voice=PASSIVE	
sed	sed	CONJ	_	
apud	apud	PREP	_	
subiectos	subicio	VB	number=PLURAL|tense=PERF|mood=PARTICIPLE|voice=PASSIVE|gender=MASCULINE|case=ACCUSATIVE	
apud	apud	PREP	_	
proximos	propior	ADJ	number=PLURAL|gender=MASCULINE|case=ACCUSATIVE|degree=SUPERLATIVE	
apud	apud	PREP	_	
collegas	collega	NN	number=PLURAL|gender=MASCULINE|case=ACCUSATIVE	
variis	varius	ADJ	number=PLURAL|gender=FEMININE|case=ABLATIVE	
inlecebris	illecebra	NN	number=PLURAL|gender=FEMININE|case=ABLATIVE	
potens	possum	VB	number=SINGULAR|tense=PR|mood=PARTICIPLE|gender=MASCULINE|case=NOMINATIVE	
et	et	CONJ	_	
cui	qui	PRON	number=SINGULAR|gender=MASCULINE|case=DATIVE	
expeditius	expedio	VB	number=SINGULAR|tense=PERF|mood=PARTICIPLE|voice=PASSIVE|gender=NEUTER|case=NOMINATIVE|degree=COMPARATIVE	
fuerit	sum	VB	person=PERSON_3|number=SINGULAR|tense=PERF|mood=SUBJUNCTIVE|voice=ACTIVE	
tradere	trado	VB	tense=PR|mood=INFINITIVE|voice=ACTIVE	
imperium	imperium	NN	number=SINGULAR|gender=NEUTER|case=ACCUSATIVE	
quam	quam	ADV	_	
obtinere	obtineo	VB	tense=PR|mood=INFINITIVE|voice=ACTIVE	
fuit	sum	VB	person=PERSON_3|number=SINGULAR|tense=PERF|mood=INDICATIVE|voice=ACTIVE	
fuit	sum	VB	person=PERSON_3|number=SINGULAR|tense=PERF|mood=INDICATIVE|voice=ACTIVE	
crebrioribus	creber	ADJ	number=PLURAL|gender=NEUTER|case=ABLATIVE|degree=COMPARATIVE	
in	in	PREP	_	
dies	dies	NN	number=PLURAL|gender=MASCULINE|case=ACCUSATIVE	
Germanicae	Germanicus	ADJ	number=SINGULAR|gender=FEMININE|case=GENITIVE	
defectionis	defectio	NN	number=SINGULAR|gender=FEMININE|case=GENITIVE	
nuntiis	nuntius	ADJ	number=PLURAL|gender=NEUTER|case=ABLATIVE	
et	et	CONJ	_	
facili	facilis	ADJ	number=SINGULAR|gender=FEMININE|case=ABLATIVE	
civitate	civitas	NN	number=SINGULAR|gender=FEMININE|case=ABLATIVE	
ad	ad	PREP	_	
accipienda	accipio	VB	number=PLURAL|mood=GERUNDIVE|gender=NEUTER|case=ACCUSATIVE	
credenda	credo	VB	number=PLURAL|mood=GERUNDIVE|gender=NEUTER|case=ACCUSATIVE	
-que	que	CONJ	_	
omnia	omnis	ADJ	number=PLURAL|gender=NEUTER|case=ACCUSATIVE	
nova	novus	ADJ	number=PLURAL|gender=NEUTER|case=ACCUSATIVE	
cum	cum	CONJ	_	
tristia	tristis	ADJ	number=PLURAL|gender=NEUTER|case=NOMINATIVE	
sunt	sum	VB	person=PERSON_3|number=PLURAL|tense=PR|mood=INDICATIVE|voice=ACTIVE	
censuerant	censeo	VB	person=PERSON_3|number=PLURAL|tense=PLUSQUAMPERFECT|mood=INDICATIVE|voice=ACTIVE	
patres	pater	NN	number=PLURAL|gender=MASCULINE|case=NOMINATIVE	
mittendos	mitto	VB	number=PLURAL|mood=GERUNDIVE|gender=MASCULINE|case=ACCUSATIVE	
ad	ad	PREP	_	
Germanicum	Germanicus	ADJ	number=SINGULAR|gender=MASCULINE|case=ACCUSATIVE	
exercitum	exercitus	NN	number=SINGULAR|gender=MASCULINE|case=ACCUSATIVE	
legatos	lego	VB	number=PLURAL|tense=PERF|mood=PARTICIPLE|voice=PASSIVE|gender=MASCULINE|case=ACCUSATIVE	
mortem	mors	NN	number=SINGULAR|gender=FEMININE|case=ACCUSATIVE	
omnibus	omnis	ADJ	number=PLURAL|gender=MASCULINE|case=DATIVE	
ex	ex	PREP	_	
natura	natura	NN	number=SINGULAR|gender=FEMININE|case=ABLATIVE	
aequalem	aequalis	ADJ	number=SINGULAR|gender=FEMININE|case=ACCUSATIVE	
oblivione	oblivio	NN	number=SINGULAR|gender=FEMININE|case=ABLATIVE	
apud	apud	PREP	_	
posteros	posterus	ADJ	number=PLURAL|gender=MASCULINE|case=ACCUSATIVE	
vel	vel	CONJ	_	
gloria	gloria	NN	number=SINGULAR|gender=FEMININE|case=ABLATIVE	
distingui	distinguo	VB	tense=PR|mood=INFINITIVE|voice=PASSIVE	
nec	neque	CONJ	_	
enim	enim	CONJ	_	
umquam	umquam	ADV	_	
atrocioribus	atrox	ADJ	number=PLURAL|gender=FEMININE|case=ABLATIVE|degree=COMPARATIVE	
populi	populus	NN	number=SINGULAR|gender=MASCULINE|case=GENITIVE	
Romani	Romanus	ADJ	number=SINGULAR|gender=MASCULINE|case=GENITIVE	
cladibus	clades	NN	number=PLURAL|gender=FEMININE|case=ABLATIVE	
magis	magnus	ADV	degree=COMPARATIVE	
-ve	ve	CONJ	_	
iustis	justus	ADJ	number=PLURAL|gender=NEUTER|case=ABLATIVE	
indiciis	indicium	NN	number=PLURAL|gender=NEUTER|case=ABLATIVE	
adprobatum	approbo	VB	number=SINGULAR|tense=PERF|mood=PARTICIPLE|voice=PASSIVE|gender=NEUTER|case=NOMINATIVE	
est	sum	VB	person=PERSON_3|number=SINGULAR|tense=PR|mood=INDICATIVE|voice=ACTIVE	
non	non	ADV	_	
esse	sum	VB	tense=PR|mood=INFINITIVE|voice=ACTIVE	
curae	cura	NN	number=SINGULAR|gender=FEMININE|case=DATIVE	
deis	deus	NN	number=PLURAL|gender=MASCULINE|case=DATIVE	
securitatem	securitas	NN	number=SINGULAR|gender=FEMININE|case=ACCUSATIVE	
nostram	noster	PRON	number=SINGULAR|gender=FEMININE|case=ACCUSATIVE	
esse	sum	VB	tense=PR|mood=INFINITIVE|voice=ACTIVE	
ultionem	ultio	NN	number=SINGULAR|gender=FEMININE|case=ACCUSATIVE	
hi	hic	PRON	number=PLURAL|gender=MASCULINE|case=NOMINATIVE	
discordes	discors	ADJ	number=PLURAL|gender=MASCULINE|case=NOMINATIVE	
et	et	CONJ	_	
rebus	res	NN	number=PLURAL|gender=FEMININE|case=ABLATIVE	
minoribus	parvus	ADJ	number=PLURAL|gender=FEMININE|case=ABLATIVE|degree=COMPARATIVE	
sibi	sui	PRON	number=PLURAL|gender=MASCULINE|case=DATIVE	
quisque	quisque	PRON	number=SINGULAR|gender=MASCULINE|case=NOMINATIVE	
tendentes	tendo	VB	number=PLURAL|tense=PR|mood=PARTICIPLE|gender=MASCULINE|case=NOMINATIVE	
circa	circa	PREP	_	
consilium	consilium	NN	number=SINGULAR|gender=NEUTER|case=ACCUSATIVE	
eligendi	eligo	VB	number=SINGULAR|mood=GERUNDIVE|gender=MASCULINE|case=GENITIVE	
successoris	successor	NN	number=SINGULAR|gender=MASCULINE|case=GENITIVE	
in	in	PREP	_	
duas	duo	NRL	number=PLURAL|gender=FEMININE|case=ACCUSATIVE	
factiones	factio	NN	number=PLURAL|gender=FEMININE|case=ACCUSATIVE	
scindebantur	scindo	VB	person=PERSON_3|number=PLURAL|tense=IMP|mood=INDICATIVE|voice=PASSIVE	
mihi	ego	PRON	number=SINGULAR|gender=MASCULINE|case=DATIVE	
ac	atque	CONJ	_	
tibi	tu	PRON	number=SINGULAR|gender=MASCULINE|case=DATIVE	
providendum	provideo	VB	number=SINGULAR|mood=GERUNDIVE|gender=NEUTER|case=NOMINATIVE	
est	edo	VB	person=PERSON_3|number=SINGULAR|tense=PR|mood=INDICATIVE|voice=ACTIVE	
ne	ne	ADV	_	
etiam	etiam	CONJ	_	
a	ab	PREP	_	
bonis	bonus	ADJ	number=PLURAL|gender=MASCULINE|case=ABLATIVE	
desideretur	desidero	VB	person=PERSON_3|number=SINGULAR|tense=PR|mood=SUBJUNCTIVE|voice=PASSIVE	
neque	neque	CONJ	_	
enim	enim	CONJ	_	
hic	hic	ADV	_	
ut	ut	CONJ	_	
gentibus	gens	NN	number=PLURAL|gender=FEMININE|case=DATIVE	
quae	qui	PRON	number=PLURAL|gender=FEMININE|case=NOMINATIVE	
regnantur	regno	VB	person=PERSON_3|number=PLURAL|tense=PR|mood=INDICATIVE|voice=PASSIVE	
certa	certus	ADJ	number=SINGULAR|gender=FEMININE|case=NOMINATIVE	
dominorum	dominus	NN	number=PLURAL|gender=MASCULINE|case=GENITIVE	
domus	domus	NN	number=SINGULAR|gender=FEMININE|case=NOMINATIVE	
et	et	CONJ	_	
ceteri	ceter	ADJ	number=PLURAL|gender=MASCULINE|case=NOMINATIVE	
servi	servus	NN	number=PLURAL|gender=MASCULINE|case=NOMINATIVE	
sed	sed	CONJ	_	
imperaturus	impero	VB	number=SINGULAR|tense=FUTURE|mood=PARTICIPLE|voice=ACTIVE|gender=MASCULINE|case=NOMINATIVE	
es	sum	VB	person=PERSON_2|number=SINGULAR|tense=PR|mood=INDICATIVE|voice=ACTIVE	
hominibus	homo	NN	number=PLURAL|gender=MASCULINE|case=DATIVE	
qui	qui	PRON	number=PLURAL|gender=MASCULINE|case=NOMINATIVE	
nec	neque	CONJ	_	
totam	totus	ADJ	number=SINGULAR|gender=FEMININE|case=ACCUSATIVE	
servitutem	servitus	NN	number=SINGULAR|gender=FEMININE|case=ACCUSATIVE	
pati	patior	VB	tense=PR|mood=INFINITIVE|voice=DEPONENS	
possunt	possum	VB	person=PERSON_3|number=PLURAL|tense=PR|mood=INDICATIVE|voice=ACTIVE	
nec	neque	CONJ	_	
totam	totus	ADJ	number=SINGULAR|gender=FEMININE|case=ACCUSATIVE	
libertatem	libertas	NN	number=SINGULAR|gender=FEMININE|case=ACCUSATIVE	
est	sum	VB	person=PERSON_3|number=SINGULAR|tense=PR|mood=INDICATIVE|voice=ACTIVE	
est	sum	VB	person=PERSON_3|number=SINGULAR|tense=PR|mood=INDICATIVE|voice=ACTIVE	
corrupti	corrumpo	VB	number=PLURAL|tense=PERF|mood=PARTICIPLE|voice=PASSIVE|gender=MASCULINE|case=NOMINATIVE	
in	in	PREP	_	
dominos	dominus	NN	number=PLURAL|gender=MASCULINE|case=ACCUSATIVE	
servi	servus	NN	number=PLURAL|gender=MASCULINE|case=NOMINATIVE	
in	in	PREP	_	
patronos	patronus	NN	number=PLURAL|gender=MASCULINE|case=ACCUSATIVE	
liberti	libertus	ADJ	number=PLURAL|gender=MASCULINE|case=NOMINATIVE	
corrupti	corrumpo	VB	number=PLURAL|tense=PERF|mood=PARTICIPLE|voice=PASSIVE|gender=MASCULINE|case=NOMINATIVE	
haustae	haurio	VB	number=PLURAL|tense=PERF|mood=PARTICIPLE|voice=PASSIVE|gender=FEMININE|case=NOMINATIVE	
aut	aut	CONJ	_	
obrutae	obruo	VB	number=PLURAL|tense=PERF|mood=PARTICIPLE|voice=PASSIVE|gender=FEMININE|case=NOMINATIVE	
urbes	urbs	NN	number=PLURAL|gender=FEMININE|case=NOMINATIVE	
fecundissima	fecundus	ADJ	number=SINGULAR|gender=FEMININE|case=NOMINATIVE|degree=SUPERLATIVE	
Campaniae	Campania	NN	number=SINGULAR|gender=FEMININE|case=GENITIVE	
ora	ora	NN	number=SINGULAR|gender=FEMININE|case=NOMINATIVE	
loco	locus	NN	number=SINGULAR|gender=MASCULINE|case=ABLATIVE	
libertatis	libertas	NN	number=SINGULAR|gender=FEMININE|case=GENITIVE	
erit	sum	VB	person=PERSON_3|number=SINGULAR|tense=FUTURE|mood=INDICATIVE|voice=ACTIVE	
quod	quod	CONJ	_	
eligi	eligo	VB	tense=PR|mood=INFINITIVE|voice=PASSIVE	
coepimus	coepio	VB	person=PERSON_1|number=PLURAL|tense=PERF|mood=INDICATIVE|voice=ACTIVE	
et	et	CONJ	_	
cuncta	cunctus	ADJ	number=PLURAL|gender=NEUTER|case=ACCUSATIVE	
scrutantibus	scrutor	VB	number=PLURAL|tense=PR|mood=PARTICIPLE|gender=MASCULINE|case=DATIVE	
iustissimum	justus	ADJ	number=SINGULAR|gender=NEUTER|case=NOMINATIVE|degree=SUPERLATIVE	
visum	video	VB	number=SINGULAR|tense=PERF|mood=PARTICIPLE|voice=PASSIVE|gender=NEUTER|case=NOMINATIVE	
est	sum	VB	person=PERSON_3|number=SINGULAR|tense=PR|mood=INDICATIVE|voice=ACTIVE	
inde	inde	ADV	_	
repeti	repeto	VB	tense=PR|mood=INFINITIVE|voice=PASSIVE	
ubi	ubi	ADV	_	
inopiae	inopia	NN	number=SINGULAR|gender=FEMININE|case=GENITIVE	
causa	causa	NN	number=SINGULAR|gender=FEMININE|case=NOMINATIVE	
erat	sum	VB	person=PERSON_3|number=SINGULAR|tense=IMP|mood=INDICATIVE|voice=ACTIVE	
per	per	PREP	_	
ceteros	ceterus	ADJ	number=PLURAL|gender=MASCULINE|case=ACCUSATIVE	
maestitia	maestitia	NN	number=SINGULAR|gender=FEMININE|case=NOMINATIVE	
ac	atque	CONJ	_	
silentium	silentium	NN	number=SINGULAR|gender=NEUTER|case=NOMINATIVE	
tamquam	tamquam	ADV	_	
usurpatam	usurpo	VB	number=SINGULAR|tense=PERF|mood=PARTICIPLE|voice=PASSIVE|gender=FEMININE|case=ACCUSATIVE	
etiam	etiam	CONJ	_	
in	in	PREP	_	
pace	pax	NN	number=SINGULAR|gender=FEMININE|case=ABLATIVE	
donativi	donativum	NN	number=SINGULAR|gender=NEUTER|case=GENITIVE	
necessitatem	necessitas	NN	number=SINGULAR|gender=FEMININE|case=ACCUSATIVE	
bello	bellum	NN	number=SINGULAR|gender=NEUTER|case=ABLATIVE	
perdidissent	perdo	VB	person=PERSON_3|number=PLURAL|tense=PLUSQUAMPERFECT|mood=SUBJUNCTIVE|voice=ACTIVE	
sunt	sum	VB	person=PERSON_3|number=PLURAL|tense=PR|mood=INDICATIVE|voice=ACTIVE	
Galliae	Gallia	NN	number=PLURAL|gender=FEMININE|case=NOMINATIVE	
super	super	PREP	_	
memoriam	memoria	NN	number=SINGULAR|gender=FEMININE|case=ACCUSATIVE	
Vindicis	Vindex	NN	number=SINGULAR|gender=MASCULINE|case=GENITIVE	
obligatae	obligo	VB	number=PLURAL|tense=PERF|mood=PARTICIPLE|voice=PASSIVE|gender=FEMININE|case=NOMINATIVE	
recenti	recens	ADJ	number=SINGULAR|gender=NEUTER|case=ABLATIVE	
dono	donum	NN	number=SINGULAR|gender=NEUTER|case=ABLATIVE	
Romanae	Romanus	ADJ	number=SINGULAR|gender=FEMININE|case=GENITIVE	
civitatis	civitas	NN	number=SINGULAR|gender=FEMININE|case=GENITIVE	
et	et	CONJ	_	
in	in	PREP	_	
posterum	posterus	ADJ	number=SINGULAR|gender=NEUTER|case=ACCUSATIVE	
tributi	tribuo	VB	number=SINGULAR|tense=PERF|mood=PARTICIPLE|voice=PASSIVE|gender=NEUTER|case=GENITIVE	
levamento	levamentum	NN	number=SINGULAR|gender=NEUTER|case=ABLATIVE	
nocuisse	noceo	VB	tense=PERF|mood=INFINITIVE|voice=ACTIVE	
id	is	PRON	number=SINGULAR|gender=NEUTER|case=ACCUSATIVE	
sibi	sui	PRON	number=SINGULAR|gender=MASCULINE|case=DATIVE	
apud	apud	PREP	_	
senem	senex	ADJ	number=SINGULAR|gender=MASCULINE|case=ACCUSATIVE	
principem	princeps	ADJ	number=SINGULAR|gender=MASCULINE|case=ACCUSATIVE	
magis	magnus	ADV	degree=COMPARATIVE	
nociturum	noceo	VB	number=SINGULAR|tense=FUTURE|mood=PARTICIPLE|voice=ACTIVE|gender=NEUTER|case=ACCUSATIVE	
apud	apud	PREP	_	
iuvenem	juvenis	ADJ	number=SINGULAR|gender=MASCULINE|case=ACCUSATIVE	
ingenio	ingenium	NN	number=SINGULAR|gender=NEUTER|case=ABLATIVE	
trucem	trux	ADJ	number=SINGULAR|gender=MASCULINE|case=ACCUSATIVE	
et	et	CONJ	_	
longo	longus	ADJ	number=SINGULAR|gender=NEUTER|case=ABLATIVE	
exilio	exsilium	NN	number=SINGULAR|gender=NEUTER|case=ABLATIVE	
efferatum	effero	VB	number=SINGULAR|tense=PERF|mood=PARTICIPLE|voice=PASSIVE|gender=MASCULINE|case=ACCUSATIVE	
iri	eo	VB	tense=PR|mood=INFINITIVE|voice=PASSIVE	
in	in	PREP	_	
castra	castrum	NN	number=PLURAL|gender=NEUTER|case=ACCUSATIVE	
placuit	placeo	VB	person=PERSON_3|number=SINGULAR|tense=PERF|mood=INDICATIVE|voice=ACTIVE	
mox	mox	ADV	_	
suspectum	suspicio	VB	number=SINGULAR|tense=PERF|mood=PARTICIPLE|voice=PASSIVE|gender=MASCULINE|case=ACCUSATIVE	
in	in	PREP	_	
eadem	idem	PRON	number=SINGULAR|gender=FEMININE|case=ABLATIVE	
Poppaea	Poppaea	NN	number=SINGULAR|gender=FEMININE|case=ABLATIVE	
in	in	PREP	_	
provinciam	provincia	NN	number=SINGULAR|gender=FEMININE|case=ACCUSATIVE	
Lusitaniam	Lusitania	NN	number=SINGULAR|gender=FEMININE|case=ACCUSATIVE	
specie	species	NN	number=SINGULAR|gender=FEMININE|case=ABLATIVE	
legationis	legatio	NN	number=SINGULAR|gender=FEMININE|case=GENITIVE	
seposuit	sepono	VB	person=PERSON_3|number=SINGULAR|tense=PERF|mood=INDICATIVE|voice=ACTIVE	
exactioni	exactio	NN	number=SINGULAR|gender=FEMININE|case=DATIVE	
triginta	triginta	NRL	_	
equites	eques	NN	number=PLURAL|gender=MASCULINE|case=NOMINATIVE	
Romani	Romanus	ADJ	number=PLURAL|gender=MASCULINE|case=NOMINATIVE	
praepositi	praepono	VB	number=PLURAL|tense=PERF|mood=PARTICIPLE|voice=PASSIVE|gender=MASCULINE|case=NOMINATIVE	
novum	novus	ADJ	number=SINGULAR|gender=NEUTER|case=NOMINATIVE	
officii	officium	NN	number=SINGULAR|gender=NEUTER|case=GENITIVE	
genus	genus	NN	number=SINGULAR|gender=NEUTER|case=NOMINATIVE	
et	et	CONJ	_	
ambitu	ambitus	NN	number=SINGULAR|gender=MASCULINE|case=ABLATIVE	
ac	atque	CONJ	_	
numero	numerus	NN	number=SINGULAR|gender=MASCULINE|case=ABLATIVE	
onerosum	onerosus	ADJ	number=SINGULAR|gender=NEUTER|case=NOMINATIVE	
quattuor	quattuor	NRL	_	
principes	princeps	ADJ	number=PLURAL|gender=MASCULINE|case=NOMINATIVE	
ferro	ferrum	NN	number=SINGULAR|gender=NEUTER|case=ABLATIVE	
interempti	interimo	VB	number=PLURAL|tense=PERF|mood=PARTICIPLE|voice=PASSIVE|gender=MASCULINE|case=NOMINATIVE	
nec	neque	CONJ	_	
ullum	ullus	ADJ	number=SINGULAR|gender=NEUTER|case=ACCUSATIVE	
orationi	oratio	NN	number=SINGULAR|gender=FEMININE|case=DATIVE	
aut	aut	CONJ	_	
lenocinium	lenocinium	NN	number=SINGULAR|gender=NEUTER|case=ACCUSATIVE	
addit	addo	VB	person=PERSON_3|number=SINGULAR|tense=PR|mood=INDICATIVE|voice=ACTIVE	
aut	aut	CONJ	_	
pretium	pretium	NN	number=SINGULAR|gender=NEUTER|case=ACCUSATIVE	
credo	credo	VB	person=PERSON_1|number=SINGULAR|tense=PR|mood=INDICATIVE|voice=ACTIVE	
et	et	CONJ	_	
rei	res	NN	number=SINGULAR|gender=FEMININE|case=GENITIVE	
publicae	publicus	ADJ	number=SINGULAR|gender=FEMININE|case=GENITIVE	
curam	cura	NN	number=SINGULAR|gender=FEMININE|case=ACCUSATIVE	
subisse	subeo	VB	tense=PERF|mood=INFINITIVE|voice=ACTIVE	
frustra	frustra	ADV	_	
a	ab	PREP	_	
Nerone	Nero	NN	number=SINGULAR|gender=MASCULINE|case=ABLATIVE	
translatae	transfero	VB	number=SINGULAR|tense=PERF|mood=PARTICIPLE|voice=PASSIVE|gender=FEMININE|case=GENITIVE	
si	si	CONJ	_	
apud	apud	PREP	_	
Othonem	Otho	NN	number=SINGULAR|gender=MASCULINE|case=ACCUSATIVE	
relinqueretur	relinquo	VB	person=PERSON_3|number=SINGULAR|tense=IMP|mood=SUBJUNCTIVE|voice=PASSIVE	
Fonteium	Fonteius	NN	number=SINGULAR|gender=MASCULINE|case=ACCUSATIVE	
Capitonem	Capito	NN	number=SINGULAR|gender=MASCULINE|case=ACCUSATIVE	
occisum	occido	VB	number=SINGULAR|tense=PERF|mood=PARTICIPLE|voice=PASSIVE|gender=MASCULINE|case=ACCUSATIVE	
etiam	etiam	CONJ	_	
qui	qui	PRON	number=PLURAL|gender=MASCULINE|case=NOMINATIVE	
queri	queror	VB	tense=PR|mood=INFINITIVE|voice=DEPONENS	
non	non	ADV	_	
poterant	possum	VB	person=PERSON_3|number=PLURAL|tense=IMP|mood=INDICATIVE|voice=ACTIVE	
tamen	tamen	ADV	_	
indignabantur	indignor	VB	person=PERSON_3|number=PLURAL|tense=IMP|mood=INDICATIVE|voice=DEPONENS	
Pisonis	Piso	NN	number=SINGULAR|gender=MASCULINE|case=GENITIVE	
comis	comis	ADJ	number=SINGULAR|gender=FEMININE|case=NOMINATIVE	
oratio	oratio	NN	number=SINGULAR|gender=FEMININE|case=NOMINATIVE	
fuit	sum	VB	person=PERSON_3|number=SINGULAR|tense=PERF|mood=INDICATIVE|voice=ACTIVE	
venalia	venalis	ADJ	number=PLURAL|gender=NEUTER|case=NOMINATIVE	
cuncta	cunctus	ADJ	number=PLURAL|gender=NEUTER|case=NOMINATIVE	
praepotentes	praepossum	VB	number=PLURAL|tense=PR|mood=PARTICIPLE|gender=MASCULINE|case=NOMINATIVE	
liberti	libertus	ADJ	number=PLURAL|gender=MASCULINE|case=NOMINATIVE	
servorum	servus	NN	number=PLURAL|gender=MASCULINE|case=GENITIVE	
manus	manus	NN	number=PLURAL|gender=FEMININE|case=NOMINATIVE	
subitis	subeo	VB	number=PLURAL|tense=PERF|mood=PARTICIPLE|voice=PASSIVE|gender=NEUTER|case=DATIVE	
avidae	avidus	ADJ	number=PLURAL|gender=FEMININE|case=NOMINATIVE	
et	et	CONJ	_	
tamquam	tamquam	ADV	_	
apud	apud	PREP	_	
senem	senex	NN	number=SINGULAR|gender=MASCULINE|case=ACCUSATIVE	
festinantes	festino	VB	number=PLURAL|tense=PR|mood=PARTICIPLE|gender=FEMININE|case=NOMINATIVE	
eadem	idem	PRON	number=PLURAL|gender=NEUTER|case=NOMINATIVE	
-que	que	CONJ	_	
novae	novus	ADJ	number=SINGULAR|gender=FEMININE|case=DATIVE	
aulae	aula	NN	number=SINGULAR|gender=FEMININE|case=DATIVE	
mala	malus	ADJ	number=PLURAL|gender=NEUTER|case=NOMINATIVE	
aeque	aequus	ADV	_	
gravia	gravis	ADJ	number=PLURAL|gender=NEUTER|case=NOMINATIVE	
non	non	ADV	_	
aeque	aequus	ADV	_	
excusata	excuso	VB	number=PLURAL|tense=PERF|mood=PARTICIPLE|voice=PASSIVE|gender=NEUTER|case=NOMINATIVE	
fuerunt	sum	VB	person=PERSON_3|number=PLURAL|tense=PERF|mood=INDICATIVE|voice=ACTIVE	
fuerunt	sum	VB	person=PERSON_3|number=PLURAL|tense=PERF|mood=INDICATIVE|voice=ACTIVE	
fuerunt	sum	VB	person=PERSON_3|number=PLURAL|tense=PERF|mood=INDICATIVE|voice=ACTIVE	
fuerunt	sum	VB	person=PERSON_3|number=PLURAL|tense=PERF|mood=INDICATIVE|voice=ACTIVE	
honorificum	honorificus	ADJ	number=SINGULAR|gender=NEUTER|case=ACCUSATIVE	
id	is	PRON	number=SINGULAR|gender=NEUTER|case=ACCUSATIVE	
militibus	miles	NN	number=PLURAL|gender=MASCULINE|case=DATIVE	
fore	sum	VB	tense=FUTURE|mood=INFINITIVE|voice=ACTIVE	
quorum	qui	PRON	number=PLURAL|gender=MASCULINE|case=GENITIVE	
favorem	favor	NN	number=SINGULAR|gender=MASCULINE|case=ACCUSATIVE	
ut	ut	CONJ	_	
largitione	largitio	NN	number=SINGULAR|gender=FEMININE|case=ABLATIVE	
et	et	CONJ	_	
ambitu	ambitus	NN	number=SINGULAR|gender=MASCULINE|case=ABLATIVE	
male	malus	ADV	_	
adquiri	acquiro	VB	tense=PR|mood=INFINITIVE|voice=PASSIVE	
ita	ita	ADV	_	
per	per	PREP	_	
bonas	bonus	ADJ	number=PLURAL|gender=FEMININE|case=ACCUSATIVE	
artis	ars	NN	number=PLURAL|gender=FEMININE|case=ACCUSATIVE	
haud	haud	ADV	_	
spernendum	sperno	VB	number=SINGULAR|mood=GERUNDIVE|gender=NEUTER|case=NOMINATIVE	
est	sum	VB	person=PERSON_3|number=SINGULAR|tense=PR|mood=INDICATIVE|voice=ACTIVE	
est	sum	VB	person=PERSON_3|number=SINGULAR|tense=PR|mood=INDICATIVE|voice=ACTIVE	
spernendum	sperno	VB	number=SINGULAR|mood=GERUNDIVE|gender=NEUTER|case=NOMINATIVE	
placuit	placeo	VB	person=PERSON_3|number=SINGULAR|tense=PERF|mood=INDICATIVE|voice=ACTIVE	
Germanici	Germanicus	ADJ	number=PLURAL|gender=MASCULINE|case=NOMINATIVE	
exercitus	exercitus	NN	number=PLURAL|gender=MASCULINE|case=NOMINATIVE	
quod	qui	PRON	number=SINGULAR|gender=NEUTER|case=NOMINATIVE	
periculosissimum	periculosus	ADJ	number=SINGULAR|gender=NEUTER|case=NOMINATIVE|degree=SUPERLATIVE	
in	in	PREP	_	
tantis	tantus	ADJ	number=PLURAL|gender=FEMININE|case=ABLATIVE	
viribus	vis	NN	number=PLURAL|gender=FEMININE|case=ABLATIVE	
solliciti	sollicitus	ADJ	number=PLURAL|gender=MASCULINE|case=NOMINATIVE	
et	et	CONJ	_	
irati	irascor	VB	number=PLURAL|tense=PERF|mood=PARTICIPLE|voice=DEPONENS|gender=MASCULINE|case=NOMINATIVE	
superbia	superbia	NN	number=SINGULAR|gender=FEMININE|case=ABLATIVE	
recentis	recens	ADJ	number=SINGULAR|gender=FEMININE|case=GENITIVE	
victoriae	victoria	NN	number=SINGULAR|gender=FEMININE|case=GENITIVE	
et	et	CONJ	_	
metu	metus	NN	number=SINGULAR|gender=MASCULINE|case=ABLATIVE	
tamquam	tamquam	ADV	_	
alias	alius	ADJ	number=PLURAL|gender=FEMININE|case=ACCUSATIVE	
partis	pars	NN	number=PLURAL|gender=FEMININE|case=ACCUSATIVE	
fovissent	foveo	VB	person=PERSON_3|number=PLURAL|tense=PLUSQUAMPERFECT|mood=SUBJUNCTIVE|voice=ACTIVE	
est	sum	VB	person=PERSON_3|number=SINGULAR|tense=PR|mood=INDICATIVE|voice=ACTIVE	
erant	sum	VB	person=PERSON_3|number=PLURAL|tense=IMP|mood=INDICATIVE|voice=ACTIVE	
quippe	quippe	ADV	_	
adulationi	adulatio	NN	number=SINGULAR|gender=FEMININE|case=DATIVE	
foedum	foedus	ADJ	number=SINGULAR|gender=NEUTER|case=NOMINATIVE	
crimen	crimen	NN	number=SINGULAR|gender=NEUTER|case=NOMINATIVE	
servitutis	servitus	NN	number=SINGULAR|gender=FEMININE|case=GENITIVE	
malignitati	malignitas	NN	number=SINGULAR|gender=FEMININE|case=DATIVE	
falsa	fallo	VB	number=SINGULAR|tense=PERF|mood=PARTICIPLE|voice=PASSIVE|gender=FEMININE|case=NOMINATIVE	
species	species	NN	number=SINGULAR|gender=FEMININE|case=NOMINATIVE	
libertatis	libertas	NN	number=SINGULAR|gender=FEMININE|case=GENITIVE	
inest	insum	VB	person=PERSON_3|number=SINGULAR|tense=PR|mood=INDICATIVE|voice=ACTIVE	
inest	insum	VB	person=PERSON_3|number=SINGULAR|tense=PR|mood=INDICATIVE|voice=ACTIVE	
plebs	plebs	NN	number=SINGULAR|gender=FEMININE|case=NOMINATIVE	
sordida	sordidus	ADJ	number=SINGULAR|gender=FEMININE|case=NOMINATIVE	
et	et	CONJ	_	
circo	circus	NN	number=SINGULAR|gender=MASCULINE|case=DATIVE	
ac	atque	CONJ	_	
theatris	theatrum	NN	number=PLURAL|gender=NEUTER|case=DATIVE	
sueta	suesco	VB	number=SINGULAR|tense=PERF|mood=PARTICIPLE|voice=PASSIVE|gender=FEMININE|case=NOMINATIVE	
simul	simul	ADV	_	
deterrimi	deterior	ADJ	number=PLURAL|gender=MASCULINE|case=NOMINATIVE|degree=SUPERLATIVE	
servorum	servus	ADJ	number=PLURAL|gender=MASCULINE|case=GENITIVE	
aut	aut	CONJ	_	
qui	qui	PRON	number=PLURAL|gender=MASCULINE|case=NOMINATIVE	
adesis	adedo	VB	number=PLURAL|tense=PERF|mood=PARTICIPLE|voice=PASSIVE|gender=NEUTER|case=ABLATIVE	
bonis	bonus	ADJ	number=PLURAL|gender=NEUTER|case=ABLATIVE	
per	per	PREP	_	
dedecus	dedecus	NN	number=SINGULAR|gender=NEUTER|case=ACCUSATIVE	
Neronis	Nero	NN	number=SINGULAR|gender=MASCULINE|case=GENITIVE	
alebantur	alo	VB	person=PERSON_3|number=PLURAL|tense=IMP|mood=INDICATIVE|voice=PASSIVE	
maesti	maestus	ADJ	number=PLURAL|gender=MASCULINE|case=NOMINATIVE	
et	et	CONJ	_	
rumorum	rumor	NN	number=PLURAL|gender=MASCULINE|case=GENITIVE	
avidi	avidus	ADJ	number=PLURAL|gender=MASCULINE|case=NOMINATIVE	
fuerunt	sum	VB	person=PERSON_3|number=PLURAL|tense=PERF|mood=INDICATIVE|voice=ACTIVE	
adoptandi	adopto	VB	mood=GERUND|case=GENITIVE	
iudicium	judicium	NN	number=SINGULAR|gender=NEUTER|case=NOMINATIVE	
integrum	integer	ADJ	number=SINGULAR|gender=NEUTER|case=NOMINATIVE	
et	et	CONJ	_	
si	si	CONJ	_	
velis	volo	VB	person=PERSON_2|number=SINGULAR|tense=PR|mood=SUBJUNCTIVE|voice=ACTIVE	
eligere	eligo	VB	tense=PR|mood=INFINITIVE|voice=ACTIVE	
consensu	consensus	NN	number=SINGULAR|gender=MASCULINE|case=ABLATIVE	
monstratur	monstro	VB	person=PERSON_3|number=SINGULAR|tense=PR|mood=INDICATIVE|voice=PASSIVE	
est	sum	VB	person=PERSON_3|number=SINGULAR|tense=PR|mood=INDICATIVE|voice=ACTIVE	
appellari	appello	VB	tense=PR|mood=INFINITIVE|voice=PASSIVE	
singulos	singuli	NRL	number=PLURAL|gender=MASCULINE|case=ACCUSATIVE	
iussit	jubeo	VB	person=PERSON_3|number=SINGULAR|tense=PERF|mood=INDICATIVE|voice=ACTIVE	
decima	decimus	NRL	number=SINGULAR|gender=FEMININE|case=ABLATIVE	
parte	pars	NN	number=SINGULAR|gender=FEMININE|case=ABLATIVE	
liberalitatis	liberalitas	NN	number=SINGULAR|gender=FEMININE|case=GENITIVE	
apud	apud	PREP	_	
quemque	quisque	PRON	number=SINGULAR|gender=MASCULINE|case=ACCUSATIVE	
eorum	is	PRON	number=PLURAL|gender=MASCULINE|case=GENITIVE	
relicta	relinquo	VB	number=SINGULAR|tense=PERF|mood=PARTICIPLE|voice=PASSIVE|gender=FEMININE|case=ABLATIVE	
proinde	proinde	ADV	_	
agendum	ago	VB	number=SINGULAR|mood=GERUNDIVE|gender=NEUTER|case=NOMINATIVE	
audendum	audeo	VB	number=SINGULAR|mood=GERUNDIVE|gender=NEUTER|case=NOMINATIVE	
-que	que	CONJ	_	
dum	dum	CONJ	_	
Galbae	Galba	NN	number=SINGULAR|gender=MASCULINE|case=GENITIVE	
auctoritas	auctoritas	NN	number=SINGULAR|gender=FEMININE|case=NOMINATIVE	
fluxa	fluo	VB	number=SINGULAR|tense=PERF|mood=PARTICIPLE|voice=PASSIVE|gender=FEMININE|case=NOMINATIVE	
Pisonis	Piso	NN	number=SINGULAR|gender=MASCULINE|case=GENITIVE	
nondum	nondum	CONJ	_	
coaluisset	coalesco	VB	person=PERSON_3|number=SINGULAR|tense=PLUSQUAMPERFECT|mood=SUBJUNCTIVE|voice=ACTIVE	
auctoritas	auctoritas	NN	number=SINGULAR|gender=FEMININE|case=NOMINATIVE	
delatum	defero	VB	number=SINGULAR|tense=PERF|mood=PARTICIPLE|voice=PASSIVE|gender=NEUTER|case=ACCUSATIVE	
ei	is	PRON	number=SINGULAR|gender=MASCULINE|case=DATIVE	
a	ab	PREP	_	
milite	miles	NN	number=SINGULAR|gender=MASCULINE|case=ABLATIVE	
imperium	imperium	NN	number=SINGULAR|gender=NEUTER|case=ACCUSATIVE	
conveniebat	convenio	VB	person=PERSON_3|number=SINGULAR|tense=IMP|mood=INDICATIVE|voice=ACTIVE	
legati	lego	VB	number=PLURAL|tense=PERF|mood=PARTICIPLE|voice=PASSIVE|gender=MASCULINE|case=NOMINATIVE	
quoque	quoque	ADV	_	
nam	nam	CONJ	_	
senatus	senatus	NN	number=SINGULAR|gender=MASCULINE|case=NOMINATIVE	
electionem	electio	NN	number=SINGULAR|gender=FEMININE|case=ACCUSATIVE	
Galbae	Galba	NN	number=SINGULAR|gender=MASCULINE|case=DATIVE	
permiserat	permitto	VB	person=PERSON_3|number=SINGULAR|tense=PLUSQUAMPERFECT|mood=INDICATIVE|voice=ACTIVE	
foeda	foedus	ADJ	number=SINGULAR|gender=FEMININE|case=ABLATIVE	
inconstantia	inconstantia	NN	number=SINGULAR|gender=FEMININE|case=ABLATIVE	
nominati	nomino	VB	number=PLURAL|tense=PERF|mood=PARTICIPLE|voice=PASSIVE|gender=MASCULINE|case=NOMINATIVE	
excusati	excuso	VB	number=PLURAL|tense=PERF|mood=PARTICIPLE|voice=PASSIVE|gender=MASCULINE|case=NOMINATIVE	
substituti	substituo	VB	number=PLURAL|tense=PERF|mood=PARTICIPLE|voice=PASSIVE|gender=MASCULINE|case=NOMINATIVE	
ambitu	ambitus	NN	number=SINGULAR|gender=MASCULINE|case=ABLATIVE	
remanendi	remaneo	VB	mood=GERUND|case=GENITIVE	
aut	aut	CONJ	_	
eundi	eo	VB	mood=GERUND|case=GENITIVE	
ut	ut	ADV	_	
quemque	quisque	PRON	number=SINGULAR|gender=MASCULINE|case=ACCUSATIVE	
metus	metus	NN	number=SINGULAR|gender=MASCULINE|case=NOMINATIVE	
vel	vel	CONJ	_	
spes	spes	NN	number=SINGULAR|gender=FEMININE|case=NOMINATIVE	
impulerat	impello	VB	person=PERSON_3|number=SINGULAR|tense=PLUSQUAMPERFECT|mood=INDICATIVE|voice=ACTIVE	
sit	sum	VB	person=PERSON_3|number=SINGULAR|tense=PR|mood=SUBJUNCTIVE|voice=ACTIVE	
ante	ante	PREP	_	
oculos	oculus	NN	number=PLURAL|gender=MASCULINE|case=ACCUSATIVE	
Nero	Nero	NN	number=SINGULAR|gender=MASCULINE|case=NOMINATIVE	
quem	qui	PRON	number=SINGULAR|gender=MASCULINE|case=ACCUSATIVE	
longa	longus	ADJ	number=SINGULAR|gender=FEMININE|case=ABLATIVE	
Caesarum	Caesar	NN	number=PLURAL|gender=MASCULINE|case=GENITIVE	
serie	series	NN	number=SINGULAR|gender=FEMININE|case=ABLATIVE	
tumentem	tumeo	VB	number=SINGULAR|tense=PR|mood=PARTICIPLE|gender=MASCULINE|case=ACCUSATIVE	
non	non	ADV	_	
Vindex	Vindex	NN	number=SINGULAR|gender=MASCULINE|case=NOMINATIVE	
cum	cum	PREP	_	
inermi	inermis	ADJ	number=SINGULAR|gender=FEMININE|case=ABLATIVE	
provincia	provincia	NN	number=SINGULAR|gender=FEMININE|case=ABLATIVE	
aut	aut	CONJ	_	
ego	ego	PRON	number=SINGULAR|gender=MASCULINE|case=NOMINATIVE	
cum	cum	PREP	_	
una	unus	NRL	number=SINGULAR|gender=FEMININE|case=ABLATIVE	
legione	legio	NN	number=SINGULAR|gender=FEMININE|case=ABLATIVE	
sed	sed	CONJ	_	
sua	suus	PRON	number=SINGULAR|gender=FEMININE|case=NOMINATIVE	
immanitas	immanitas	NN	number=SINGULAR|gender=FEMININE|case=NOMINATIVE	
sua	suus	PRON	number=SINGULAR|gender=FEMININE|case=NOMINATIVE	
luxuria	luxuria	NN	number=SINGULAR|gender=FEMININE|case=NOMINATIVE	
cervicibus	cervix	NN	number=PLURAL|gender=FEMININE|case=ABLATIVE	
publicis	publicus	ADJ	number=PLURAL|gender=FEMININE|case=ABLATIVE	
depulerunt	depello	VB	person=PERSON_3|number=PLURAL|tense=PERF|mood=INDICATIVE|voice=ACTIVE	
secundae	secundus	ADJ	number=PLURAL|gender=FEMININE|case=NOMINATIVE	
res	res	NN	number=PLURAL|gender=FEMININE|case=NOMINATIVE	
acrioribus	acer	ADJ	number=PLURAL|gender=MASCULINE|case=ABLATIVE|degree=COMPARATIVE	
stimulis	stimulus	NN	number=PLURAL|gender=MASCULINE|case=ABLATIVE	
animos	animus	NN	number=PLURAL|gender=MASCULINE|case=ACCUSATIVE	
explorant	exploro	VB	person=PERSON_3|number=PLURAL|tense=PR|mood=INDICATIVE|voice=ACTIVE	
quia	quia	CONJ	_	
miseriae	miseria	NN	number=PLURAL|gender=FEMININE|case=NOMINATIVE	
tolerantur	tolero	VB	person=PERSON_3|number=PLURAL|tense=PR|mood=INDICATIVE|voice=PASSIVE	
felicitate	felicitas	NN	number=SINGULAR|gender=FEMININE|case=ABLATIVE	
corrumpimur	corrumpo	VB	person=PERSON_1|number=PLURAL|tense=PR|mood=INDICATIVE|voice=PASSIVE	
sed	sed	CONJ	_	
Augustus	Augustus	NN	number=SINGULAR|gender=MASCULINE|case=NOMINATIVE	
in	in	PREP	_	
domo	domus	NN	number=SINGULAR|gender=FEMININE|case=ABLATIVE	
successorem	successor	NN	number=SINGULAR|gender=MASCULINE|case=ACCUSATIVE	
quaesivit	quaero	VB	person=PERSON_3|number=SINGULAR|tense=PERF|mood=INDICATIVE|voice=ACTIVE	
ego	ego	PRON	number=SINGULAR|gender=MASCULINE|case=NOMINATIVE	
in	in	PREP	_	
re	res	NN	number=SINGULAR|gender=FEMININE|case=ABLATIVE	
publica	publicus	ADJ	number=SINGULAR|gender=FEMININE|case=ABLATIVE	
non	non	ADV	_	
quia	quia	CONJ	_	
propinquos	propinquus	ADJ	number=PLURAL|gender=MASCULINE|case=ACCUSATIVE	
aut	aut	CONJ	_	
socios	socius	ADJ	number=PLURAL|gender=MASCULINE|case=ACCUSATIVE	
belli	bellum	NN	number=SINGULAR|gender=NEUTER|case=GENITIVE	
non	non	ADV	_	
habeam	habeo	VB	person=PERSON_1|number=SINGULAR|tense=PR|mood=SUBJUNCTIVE|voice=ACTIVE	
sed	sed	CONJ	_	
neque	neque	CONJ	_	
ipse	ipse	PRON	number=SINGULAR|gender=MASCULINE|case=NOMINATIVE	
imperium	imperium	NN	number=SINGULAR|gender=NEUTER|case=ACCUSATIVE	
ambitione	ambitio	NN	number=SINGULAR|gender=FEMININE|case=ABLATIVE	
accepi	accipio	VB	person=PERSON_1|number=SINGULAR|tense=PERF|mood=INDICATIVE|voice=ACTIVE	
et	et	CONJ	_	
iudicii	judicium	NN	number=SINGULAR|gender=NEUTER|case=GENITIVE	
mei	meus	PRON	number=SINGULAR|gender=NEUTER|case=GENITIVE	
documentum	documentum	NN	number=SINGULAR|gender=NEUTER|case=NOMINATIVE	
sit	sum	VB	person=PERSON_3|number=SINGULAR|tense=PR|mood=SUBJUNCTIVE|voice=ACTIVE	
non	non	ADV	_	
meae	meus	PRON	number=PLURAL|gender=FEMININE|case=NOMINATIVE	
tantum	tantus	ADV	_	
necessitudines	necessitudo	NN	number=PLURAL|gender=FEMININE|case=NOMINATIVE	
quas	qui	PRON	number=PLURAL|gender=FEMININE|case=ACCUSATIVE	
tibi	tu	PRON	number=SINGULAR|gender=MASCULINE|case=DATIVE	
postposui	postpono	VB	person=PERSON_1|number=SINGULAR|tense=PERF|mood=INDICATIVE|voice=ACTIVE	
sed	sed	CONJ	_	
et	et	CONJ	_	
tuae	tuus	PRON	number=PLURAL|gender=FEMININE|case=NOMINATIVE	
quaesivi	quaero	VB	person=PERSON_1|number=SINGULAR|tense=PERF|mood=INDICATIVE|voice=ACTIVE	
quia	quia	CONJ	_	
nos	nos	PRON	number=PLURAL|gender=MASCULINE|case=NOMINATIVE	
bello	bellum	NN	number=SINGULAR|gender=NEUTER|case=ABLATIVE	
et	et	CONJ	_	
ab	ab	PREP	_	
aestimantibus	aestimo	VB	number=PLURAL|tense=PR|mood=PARTICIPLE|gender=MASCULINE|case=ABLATIVE	
adsciti	ascio	VB	number=PLURAL|tense=PERF|mood=PARTICIPLE|voice=PASSIVE|gender=MASCULINE|case=NOMINATIVE	
cum	cum	PREP	_	
invidia	invidia	NN	number=SINGULAR|gender=FEMININE|case=ABLATIVE	
quamvis	quamvis	ADV	_	
egregii	egregius	ADJ	number=PLURAL|gender=MASCULINE|case=NOMINATIVE	
erimus	sum	VB	person=PERSON_1|number=PLURAL|tense=FUTURE|mood=INDICATIVE|voice=ACTIVE	
erimus	sum	VB	person=PERSON_1|number=PLURAL|tense=FUTURE|mood=INDICATIVE|voice=ACTIVE	
pollutae	polluo	VB	number=PLURAL|tense=PERF|mood=PARTICIPLE|voice=PASSIVE|gender=FEMININE|case=NOMINATIVE	
caerimoniae	caerimonia	NN	number=PLURAL|gender=FEMININE|case=NOMINATIVE	
magna	magnus	ADJ	number=PLURAL|gender=NEUTER|case=NOMINATIVE	
adulteria	adulterium	NN	number=PLURAL|gender=NEUTER|case=NOMINATIVE	
fuerunt	sum	VB	person=PERSON_3|number=PLURAL|tense=PERF|mood=INDICATIVE|voice=ACTIVE	
Non	non	ADV	_	
tamen	tamen	ADV	_	
adeo	adeo	ADV	_	
virtutum	virtus	NN	number=PLURAL|gender=FEMININE|case=GENITIVE	
sterile	sterilis	ADJ	number=SINGULAR|gender=NEUTER|case=NOMINATIVE	
saeculum	saeculum	NN	number=SINGULAR|gender=NEUTER|case=NOMINATIVE	
ut	ut	CONJ	_	
non	non	ADV	_	
et	et	CONJ	_	
bona	bonus	ADJ	number=PLURAL|gender=NEUTER|case=ACCUSATIVE	
exempla	exemplum	NN	number=PLURAL|gender=NEUTER|case=ACCUSATIVE	
prodiderit	prodo	VB	person=PERSON_3|number=SINGULAR|tense=PERF|mood=SUBJUNCTIVE|voice=ACTIVE	
fuit	sum	VB	person=PERSON_3|number=SINGULAR|tense=PERF|mood=INDICATIVE|voice=ACTIVE	
Vinius	Vinius	NN	number=SINGULAR|gender=MASCULINE|case=NOMINATIVE	
pro	pro	PREP	_	
M.	Marcus	NN	number=SINGULAR|gender=MASCULINE|case=ABLATIVE	
Othone	Otho	NN	number=SINGULAR|gender=MASCULINE|case=ABLATIVE	
Laco	Laco	NN	number=SINGULAR|gender=MASCULINE|case=NOMINATIVE	
atque	atque	CONJ	_	
Icelus	Icelus	NN	number=SINGULAR|gender=MASCULINE|case=NOMINATIVE	
consensu	consensus	NN	number=SINGULAR|gender=MASCULINE|case=ABLATIVE	
non	non	ADV	_	
tam	tam	ADV	_	
unum	unus	NRL	number=SINGULAR|gender=MASCULINE|case=ACCUSATIVE	
aliquem	aliquis	PRON	number=SINGULAR|gender=MASCULINE|case=ACCUSATIVE	
fovebant	foveo	VB	person=PERSON_3|number=PLURAL|tense=IMP|mood=INDICATIVE|voice=ACTIVE	
quam	quam	ADV	_	
alium	alius	ADJ	number=SINGULAR|gender=MASCULINE|case=ACCUSATIVE	
erat	sum	VB	person=PERSON_3|number=SINGULAR|tense=IMP|mood=INDICATIVE|voice=ACTIVE	
nec	neque	CONJ	_	
minor	parvus	ADJ	number=SINGULAR|gender=FEMININE|case=NOMINATIVE|degree=COMPARATIVE	
gratia	gratia	NN	number=SINGULAR|gender=FEMININE|case=NOMINATIVE	
Icelo	Icelus	NN	number=SINGULAR|gender=MASCULINE|case=DATIVE	
Galbae	Galba	NN	number=SINGULAR|gender=MASCULINE|case=DATIVE	
liberto	libertus	ADJ	number=SINGULAR|gender=MASCULINE|case=DATIVE	
quem	qui	PRON	number=SINGULAR|gender=MASCULINE|case=ACCUSATIVE	
anulis	anulus	NN	number=PLURAL|gender=MASCULINE|case=ABLATIVE	
donatum	dono	VB	number=SINGULAR|tense=PERF|mood=PARTICIPLE|voice=PASSIVE|gender=MASCULINE|case=ACCUSATIVE	
equestri	equester	ADJ	number=SINGULAR|gender=NEUTER|case=ABLATIVE	
nomine	nomen	NN	number=SINGULAR|gender=NEUTER|case=ABLATIVE	
Marcianum	Marcianus	NN	number=SINGULAR|gender=MASCULINE|case=ACCUSATIVE	
vocitabant	vocito	VB	person=PERSON_3|number=PLURAL|tense=IMP|mood=INDICATIVE|voice=ACTIVE	
erat	sum	VB	person=PERSON_3|number=SINGULAR|tense=IMP|mood=INDICATIVE|voice=ACTIVE	
ac	atque	CONJ	_	
tamen	tamen	ADV	_	
grande	grandis	ADJ	number=SINGULAR|gender=NEUTER|case=NOMINATIVE	
gaudium	gaudium	NN	number=SINGULAR|gender=NEUTER|case=NOMINATIVE	
quod	quod	CONJ	_	
tam	tam	ADV	_	
pauperes	pauper	ADJ	number=PLURAL|gender=MASCULINE|case=NOMINATIVE	
forent	sum	VB	person=PERSON_3|number=PLURAL|tense=IMP|mood=SUBJUNCTIVE|voice=ACTIVE	
quibus	qui	PRON	number=PLURAL|gender=MASCULINE|case=DATIVE	
donasset	dono	VB	person=PERSON_3|number=SINGULAR|tense=PLUSQUAMPERFECT|mood=SUBJUNCTIVE|voice=ACTIVE	
Nero	Nero	NN	number=SINGULAR|gender=MASCULINE|case=NOMINATIVE	
quam	quam	ADV	_	
quibus	qui	PRON	number=PLURAL|gender=MASCULINE|case=DATIVE	
abstulisset	aufero	VB	person=PERSON_3|number=SINGULAR|tense=PLUSQUAMPERFECT|mood=SUBJUNCTIVE|voice=ACTIVE	
fuit	sum	VB	person=PERSON_3|number=SINGULAR|tense=PERF|mood=INDICATIVE|voice=ACTIVE	
nobilitas	nobilitas	NN	number=SINGULAR|gender=FEMININE|case=NOMINATIVE	
opes	ops	NN	number=PLURAL|gender=FEMININE|case=NOMINATIVE	
omissi	omitto	VB	number=PLURAL|tense=PERF|mood=PARTICIPLE|voice=PASSIVE|gender=MASCULINE|case=NOMINATIVE	
gesti	gero	VB	number=PLURAL|tense=PERF|mood=PARTICIPLE|voice=PASSIVE|gender=MASCULINE|case=NOMINATIVE	
-que	que	CONJ	_	
honores	honor	NN	number=PLURAL|gender=MASCULINE|case=NOMINATIVE	
pro	pro	PREP	_	
crimine	crimen	NN	number=SINGULAR|gender=NEUTER|case=ABLATIVE	
et	et	CONJ	_	
ob	ob	PREP	_	
virtutes	virtus	NN	number=PLURAL|gender=FEMININE|case=ACCUSATIVE	
certissimum	certus	ADJ	number=SINGULAR|gender=NEUTER|case=NOMINATIVE|degree=SUPERLATIVE	
exitium	exitium	NN	number=SINGULAR|gender=NEUTER|case=NOMINATIVE	
fuit	sum	VB	person=PERSON_3|number=SINGULAR|tense=PERF|mood=INDICATIVE|voice=ACTIVE	
fuerunt	sum	VB	person=PERSON_3|number=PLURAL|tense=PERF|mood=INDICATIVE|voice=ACTIVE	
Oriens	orior	VB	number=SINGULAR|tense=PR|mood=PARTICIPLE|gender=MASCULINE|case=NOMINATIVE	
adhuc	adhuc	ADV	_	
immotus	immotus	ADJ	number=SINGULAR|gender=MASCULINE|case=NOMINATIVE	
erat	sum	VB	person=PERSON_3|number=SINGULAR|tense=IMP|mood=INDICATIVE|voice=ACTIVE	
Superior	superus	ADJ	number=SINGULAR|gender=MASCULINE|case=NOMINATIVE|degree=COMPARATIVE	
exercitus	exercitus	NN	number=SINGULAR|gender=MASCULINE|case=NOMINATIVE	
legatum	legatus	NN	number=SINGULAR|gender=MASCULINE|case=ACCUSATIVE	
Hordeonium	Hordeonius	NN	number=SINGULAR|gender=MASCULINE|case=ACCUSATIVE	
Flaccum	Flaccus	NN	number=SINGULAR|gender=MASCULINE|case=ACCUSATIVE	
spernebat	sperno	VB	person=PERSON_3|number=SINGULAR|tense=IMP|mood=INDICATIVE|voice=ACTIVE	
senecta	senecta	NN	number=SINGULAR|gender=FEMININE|case=ABLATIVE	
ac	atque	CONJ	_	
debilitate	debilitas	NN	number=SINGULAR|gender=FEMININE|case=ABLATIVE	
pedum	pes	NN	number=PLURAL|gender=MASCULINE|case=GENITIVE	
invalidum	invalidus	ADJ	number=SINGULAR|gender=MASCULINE|case=ACCUSATIVE	
sine	sine	PREP	_	
constantia	constantia	NN	number=SINGULAR|gender=FEMININE|case=ABLATIVE	
sine	sine	PREP	_	
auctoritate	auctoritas	NN	number=SINGULAR|gender=FEMININE|case=ABLATIVE	
Invalidum	invalidus	ADJ	number=SINGULAR|gender=MASCULINE|case=ACCUSATIVE	
senem	senex	NN	number=SINGULAR|gender=MASCULINE|case=ACCUSATIVE	
Titus	Titus	NN	number=SINGULAR|gender=MASCULINE|case=NOMINATIVE	
Vinius	Vinius	NN	number=SINGULAR|gender=MASCULINE|case=NOMINATIVE	
et	et	CONJ	_	
Cornelius	Cornelius	NN	number=SINGULAR|gender=MASCULINE|case=NOMINATIVE	
Laco	Laco	NN	number=SINGULAR|gender=MASCULINE|case=NOMINATIVE	
alter	alter	ADJ	number=SINGULAR|gender=MASCULINE|case=NOMINATIVE	
deterrimus	deterior	ADJ	number=SINGULAR|gender=MASCULINE|case=NOMINATIVE|degree=SUPERLATIVE	
mortalium	mortalis	ADJ	number=PLURAL|gender=MASCULINE|case=GENITIVE	
alter	alter	ADJ	number=SINGULAR|gender=MASCULINE|case=NOMINATIVE	
ignavissimus	ignavus	ADJ	number=SINGULAR|gender=MASCULINE|case=NOMINATIVE|degree=SUPERLATIVE	
odio	odium	NN	number=SINGULAR|gender=NEUTER|case=ABLATIVE	
flagitiorum	flagitium	NN	number=PLURAL|gender=NEUTER|case=GENITIVE	
oneratum	onero	VB	number=SINGULAR|tense=PERF|mood=PARTICIPLE|voice=PASSIVE|gender=MASCULINE|case=ACCUSATIVE	
contemptu	contemptus	NN	number=SINGULAR|gender=MASCULINE|case=ABLATIVE	
inertiae	inertia	NN	number=SINGULAR|gender=FEMININE|case=GENITIVE	
destruebant	destruo	VB	person=PERSON_3|number=PLURAL|tense=IMP|mood=INDICATIVE|voice=ACTIVE	
suspectum	suspicio	VB	number=SINGULAR|tense=PERF|mood=PARTICIPLE|voice=PASSIVE|gender=MASCULINE|case=ACCUSATIVE	
semper	semper	ADV	_	
invisum	invideo	VB	number=SINGULAR|tense=PERF|mood=PARTICIPLE|voice=PASSIVE|gender=MASCULINE|case=ACCUSATIVE	
-que	que	CONJ	_	
dominantibus	dominor	VB	number=PLURAL|tense=PR|mood=PARTICIPLE|gender=MASCULINE|case=DATIVE	
qui	qui	PRON	number=SINGULAR|gender=MASCULINE|case=NOMINATIVE	
proximus	propior	ADJ	number=SINGULAR|gender=MASCULINE|case=NOMINATIVE|degree=SUPERLATIVE	
destinaretur	destino	VB	person=PERSON_3|number=SINGULAR|tense=IMP|mood=SUBJUNCTIVE|voice=PASSIVE	
Syriam	Syria	NN	number=SINGULAR|gender=FEMININE|case=ACCUSATIVE	
et	et	CONJ	_	
quattuor	quattuor	NRL	_	
legiones	legio	NN	number=PLURAL|gender=FEMININE|case=ACCUSATIVE	
obtinebat	obtineo	VB	person=PERSON_3|number=SINGULAR|tense=IMP|mood=INDICATIVE|voice=ACTIVE	
Licinius	Licinius	NN	number=SINGULAR|gender=MASCULINE|case=NOMINATIVE	
Mucianus	Mucianus	NN	number=SINGULAR|gender=MASCULINE|case=NOMINATIVE	
vir	vir	NN	number=SINGULAR|gender=MASCULINE|case=NOMINATIVE	
secundis	secundus	ADJ	number=PLURAL|gender=FEMININE|case=ABLATIVE	
adversis	adverto	VB	number=PLURAL|tense=PERF|mood=PARTICIPLE|voice=PASSIVE|gender=FEMININE|case=ABLATIVE	
-que	que	CONJ	_	
iuxta	juxta	ADV	_	
famosus	famosus	ADJ	number=SINGULAR|gender=MASCULINE|case=NOMINATIVE	
ceterum	ceter	ADV	_	
utraque	uterque	ADJ	number=SINGULAR|gender=FEMININE|case=NOMINATIVE	
caedes	caedes	NN	number=SINGULAR|gender=FEMININE|case=NOMINATIVE	
sinistre	sinister	ADV	_	
accepta	accipio	VB	number=SINGULAR|tense=PERF|mood=PARTICIPLE|voice=PASSIVE|gender=FEMININE|case=NOMINATIVE	
et	et	CONJ	_	
inviso	invideo	VB	number=SINGULAR|tense=PERF|mood=PARTICIPLE|voice=PASSIVE|gender=MASCULINE|case=DATIVE	
semel	semel	ADV	_	
principi	princeps	ADJ	number=SINGULAR|gender=MASCULINE|case=DATIVE	
seu	sive	CONJ	_	
bene	bene	ADV	_	
seu	sive	CONJ	_	
male	malus	ADV	_	
facta	facio	VB	number=PLURAL|tense=PERF|mood=PARTICIPLE|voice=PASSIVE|gender=NEUTER|case=NOMINATIVE	
parem	par	ADJ	number=SINGULAR|gender=FEMININE|case=ACCUSATIVE	
invidiam	invidia	NN	number=SINGULAR|gender=FEMININE|case=ACCUSATIVE	
adferebant	affero	VB	person=PERSON_3|number=PLURAL|tense=IMP|mood=INDICATIVE|voice=ACTIVE	
Otho	Otho	NN	number=SINGULAR|gender=MASCULINE|case=NOMINATIVE	
comiter	comis	ADV	_	
administrata	administro	VB	number=SINGULAR|tense=PERF|mood=PARTICIPLE|voice=PASSIVE|gender=FEMININE|case=ABLATIVE	
provincia	provincia	NN	number=SINGULAR|gender=FEMININE|case=ABLATIVE	
primus	primus	NRL	number=SINGULAR|gender=MASCULINE|case=NOMINATIVE	
in	in	PREP	_	
partis	pars	NN	number=PLURAL|gender=FEMININE|case=ACCUSATIVE	
transgressus	transgredior	VB	number=SINGULAR|tense=PERF|mood=PARTICIPLE|voice=DEPONENS|gender=MASCULINE|case=NOMINATIVE	
nec	neque	CONJ	_	
segnis	segnis	ADJ	number=SINGULAR|gender=MASCULINE|case=NOMINATIVE	
et	et	CONJ	_	
donec	donec	CONJ	_	
bellum	bellum	NN	number=SINGULAR|gender=NEUTER|case=NOMINATIVE	
fuit	sum	VB	person=PERSON_3|number=SINGULAR|tense=PERF|mood=INDICATIVE|voice=ACTIVE	
inter	inter	PREP	_	
praesentis	praesum	VB	number=PLURAL|tense=PR|mood=PARTICIPLE|voice=ACTIVE|gender=MASCULINE|case=ACCUSATIVE	
splendidissimus	splendidus	ADJ	number=SINGULAR|gender=MASCULINE|case=NOMINATIVE|degree=SUPERLATIVE	
spem	spes	NN	number=SINGULAR|gender=FEMININE|case=ACCUSATIVE	
adoptionis	adoptio	NN	number=SINGULAR|gender=FEMININE|case=GENITIVE	
statim	statim	ADV	_	
conceptam	concipio	VB	number=SINGULAR|tense=PERF|mood=PARTICIPLE|voice=PASSIVE|gender=FEMININE|case=ACCUSATIVE	
acrius	acer	ADV	degree=COMPARATIVE	
in	in	PREP	_	
dies	dies	NN	number=PLURAL|gender=MASCULINE|case=ACCUSATIVE	
rapiebat	rapio	VB	person=PERSON_3|number=SINGULAR|tense=IMP|mood=INDICATIVE|voice=ACTIVE	
faventibus	faveo	VB	number=PLURAL|tense=PR|mood=PARTICIPLE|gender=MASCULINE|case=ABLATIVE	
plerisque	plerusque	ADJ	number=PLURAL|gender=MASCULINE|case=ABLATIVE	
militum	miles	NN	number=PLURAL|gender=MASCULINE|case=GENITIVE	
prona	pronus	ADJ	number=SINGULAR|gender=FEMININE|case=ABLATIVE	
in	in	PREP	_	
eum	is	PRON	number=SINGULAR|gender=MASCULINE|case=ACCUSATIVE	
aula	aula	NN	number=SINGULAR|gender=FEMININE|case=ABLATIVE	
Neronis	Nero	NN	number=SINGULAR|gender=MASCULINE|case=GENITIVE	
ut	ut	CONJ	_	
similem	similis	ADJ	number=SINGULAR|gender=MASCULINE|case=ACCUSATIVE	
Macrum	Macer	NN	number=SINGULAR|gender=MASCULINE|case=ACCUSATIVE	
in	in	PREP	_	
Africa	Africa	NN	number=SINGULAR|gender=FEMININE|case=ABLATIVE	
haud	haud	ADV	_	
dubie	dubius	ADV	_	
turbantem	turbo	VB	number=SINGULAR|tense=PR|mood=PARTICIPLE|gender=MASCULINE|case=ACCUSATIVE	
Trebonius	Trebonius	NN	number=SINGULAR|gender=MASCULINE|case=NOMINATIVE	
Garutianus	Garutianus	NN	number=SINGULAR|gender=MASCULINE|case=NOMINATIVE	
procurator	procurator	NN	number=SINGULAR|gender=MASCULINE|case=NOMINATIVE	
iussu	jussus	NN	number=SINGULAR|gender=MASCULINE|case=ABLATIVE	
Galbae	Galba	NN	number=SINGULAR|gender=MASCULINE|case=GENITIVE	
Capitonem	Capito	NN	number=SINGULAR|gender=MASCULINE|case=ACCUSATIVE	
in	in	PREP	_	
Germania	Germania	NN	number=SINGULAR|gender=FEMININE|case=ABLATIVE	
cum	cum	CONJ	_	
similia	similis	ADJ	number=PLURAL|gender=NEUTER|case=ACCUSATIVE	
coeptaret	coepto	VB	person=PERSON_3|number=SINGULAR|tense=IMP|mood=SUBJUNCTIVE|voice=ACTIVE	
Cornelius	Cornelius	NN	number=SINGULAR|gender=MASCULINE|case=NOMINATIVE	
Aquinus	Aquinus	NN	number=SINGULAR|gender=MASCULINE|case=NOMINATIVE	
et	et	CONJ	_	
Fabius	Fabius	NN	number=SINGULAR|gender=MASCULINE|case=NOMINATIVE	
Valens	Valens	NN	number=SINGULAR|gender=MASCULINE|case=NOMINATIVE	
legati	legatus	NN	number=PLURAL|gender=MASCULINE|case=NOMINATIVE	
legionum	legio	NN	number=PLURAL|gender=FEMININE|case=GENITIVE	
interfecerant	interficio	VB	person=PERSON_3|number=PLURAL|tense=PLUSQUAMPERFECT|mood=INDICATIVE|voice=ACTIVE	
antequam	antequam	CONJ	_	
iuberentur	jubeo	VB	person=PERSON_3|number=PLURAL|tense=IMP|mood=SUBJUNCTIVE|voice=PASSIVE	
interfecerat	interficio	VB	person=PERSON_3|number=SINGULAR|tense=PLUSQUAMPERFECT|mood=INDICATIVE|voice=ACTIVE	
nimiae	nimius	ADJ	number=PLURAL|gender=FEMININE|case=NOMINATIVE	
voluptates	voluptas	NN	number=PLURAL|gender=FEMININE|case=NOMINATIVE	
cum	cum	CONJ	_	
vacaret	vaco	VB	person=PERSON_3|number=SINGULAR|tense=IMP|mood=SUBJUNCTIVE|voice=ACTIVE	
fuerunt	sum	VB	person=PERSON_3|number=PLURAL|tense=PERF|mood=INDICATIVE|voice=ACTIVE	
dignitatem	dignitas	NN	number=SINGULAR|gender=FEMININE|case=ACCUSATIVE	
nostram	noster	PRON	number=SINGULAR|gender=FEMININE|case=ACCUSATIVE	
a	ab	PREP	_	
Vespasiano	Vespasianus	NN	number=SINGULAR|gender=MASCULINE|case=ABLATIVE	
incohatam	incoho	VB	number=SINGULAR|tense=PERF|mood=PARTICIPLE|voice=PASSIVE|gender=FEMININE|case=ACCUSATIVE	
a	ab	PREP	_	
Tito	Titus	NN	number=SINGULAR|gender=MASCULINE|case=ABLATIVE	
auctam	augeo	VB	number=SINGULAR|tense=PERF|mood=PARTICIPLE|voice=PASSIVE|gender=FEMININE|case=ACCUSATIVE	
a	ab	PREP	_	
Domitiano	Domitianus	NN	number=SINGULAR|gender=MASCULINE|case=ABLATIVE	
longius	longus	ADV	degree=COMPARATIVE	
provectam	proveho	VB	number=SINGULAR|tense=PERF|mood=PARTICIPLE|voice=PASSIVE|gender=FEMININE|case=ACCUSATIVE	
non	non	ADV	_	
abnuerim	abnuo	VB	person=PERSON_1|number=SINGULAR|tense=PERF|mood=SUBJUNCTIVE|voice=ACTIVE	
monere	moneo	VB	tense=PR|mood=INFINITIVE|voice=ACTIVE	
diutius	diu	ADV	degree=COMPARATIVE	
neque	neque	CONJ	_	
temporis	tempus	NN	number=SINGULAR|gender=NEUTER|case=GENITIVE	
huius	hic	PRON	number=SINGULAR|gender=NEUTER|case=GENITIVE	
et	et	CONJ	_	
impletum	impleo	VB	number=SINGULAR|tense=PERF|mood=PARTICIPLE|voice=PASSIVE|gender=NEUTER|case=NOMINATIVE	
est	sum	VB	person=PERSON_3|number=SINGULAR|tense=PR|mood=INDICATIVE|voice=ACTIVE	
omne	omnis	ADJ	number=SINGULAR|gender=NEUTER|case=NOMINATIVE	
consilium	consilium	NN	number=SINGULAR|gender=NEUTER|case=NOMINATIVE	
si	si	CONJ	_	
te	tu	PRON	number=SINGULAR|gender=MASCULINE|case=ACCUSATIVE	
bene	bene	ADV	_	
elegi	eligo	VB	person=PERSON_1|number=SINGULAR|tense=PERF|mood=INDICATIVE|voice=ACTIVE	
est	sum	VB	person=PERSON_3|number=SINGULAR|tense=PR|mood=INDICATIVE|voice=ACTIVE	
multi	multus	ADJ	number=PLURAL|gender=MASCULINE|case=NOMINATIVE	
stulta	stultus	ADJ	number=SINGULAR|gender=FEMININE|case=ABLATIVE	
spe	spes	NN	number=SINGULAR|gender=FEMININE|case=ABLATIVE	
prout	pro	ADV	_	
quis	quis	PRON	number=SINGULAR|gender=MASCULINE|case=NOMINATIVE	
amicus	amicus	NN	number=SINGULAR|gender=MASCULINE|case=NOMINATIVE	
vel	vel	CONJ	_	
cliens	cliens	NN	number=SINGULAR|gender=MASCULINE|case=NOMINATIVE	
hunc	hic	PRON	number=SINGULAR|gender=MASCULINE|case=ACCUSATIVE	
vel	vel	CONJ	_	
illum	ille	PRON	number=SINGULAR|gender=MASCULINE|case=ACCUSATIVE	
ambitiosis	ambitiosus	ADJ	number=PLURAL|gender=MASCULINE|case=DATIVE	
rumoribus	rumor	NN	number=PLURAL|gender=MASCULINE|case=DATIVE	
destinabant	destino	VB	person=PERSON_3|number=PLURAL|tense=IMP|mood=INDICATIVE|voice=ACTIVE	
etiam	etiam	CONJ	_	
in	in	PREP	_	
Titi	Titus	NN	number=SINGULAR|gender=MASCULINE|case=GENITIVE	
Vinii	Vinius	NN	number=SINGULAR|gender=MASCULINE|case=GENITIVE	
odium	odium	NN	number=SINGULAR|gender=NEUTER|case=ACCUSATIVE	
qui	qui	PRON	number=SINGULAR|gender=MASCULINE|case=NOMINATIVE	
in	in	PREP	_	
dies	dies	NN	number=PLURAL|gender=MASCULINE|case=ACCUSATIVE	
quanto	quantus	ADV	_	
potentior	possum	VB	number=SINGULAR|tense=PR|mood=PARTICIPLE|gender=MASCULINE|case=NOMINATIVE|degree=COMPARATIVE	
eodem	idem	PRON	number=SINGULAR|gender=MASCULINE|case=ABLATIVE	
actu	actus	NN	number=SINGULAR|gender=MASCULINE|case=ABLATIVE	
invisior	invideo	VB	number=SINGULAR|tense=PERF|mood=PARTICIPLE|voice=PASSIVE|gender=MASCULINE|case=NOMINATIVE|degree=COMPARATIVE	
erat	sum	VB	person=PERSON_3|number=SINGULAR|tense=IMP|mood=INDICATIVE|voice=ACTIVE	
erat	sum	VB	person=PERSON_3|number=SINGULAR|tense=IMP|mood=INDICATIVE|voice=ACTIVE	
erat	sum	VB	person=PERSON_3|number=SINGULAR|tense=IMP|mood=INDICATIVE|voice=ACTIVE	
et	et	CONJ	_	
patrum	pater	NN	number=PLURAL|gender=MASCULINE|case=GENITIVE	
favor	favor	NN	number=SINGULAR|gender=MASCULINE|case=NOMINATIVE	
aderat	adsum	VB	person=PERSON_3|number=SINGULAR|tense=IMP|mood=INDICATIVE|voice=ACTIVE	
bellum	bellum	NN	number=SINGULAR|gender=NEUTER|case=ACCUSATIVE	
Iudaicum	Judaicus	ADJ	number=SINGULAR|gender=NEUTER|case=ACCUSATIVE	
Flavius	Flavius	NN	number=SINGULAR|gender=MASCULINE|case=NOMINATIVE	
Vespasianus	Vespasianus	NN	number=SINGULAR|gender=MASCULINE|case=NOMINATIVE	
ducem	dux	NN	number=SINGULAR|gender=MASCULINE|case=ACCUSATIVE	
eum	is	PRON	number=SINGULAR|gender=MASCULINE|case=ACCUSATIVE	
Nero	Nero	NN	number=SINGULAR|gender=MASCULINE|case=NOMINATIVE	
delegerat	deligo	VB	person=PERSON_3|number=SINGULAR|tense=PLUSQUAMPERFECT|mood=INDICATIVE|voice=ACTIVE	
tribus	tres	NRL	number=PLURAL|gender=FEMININE|case=ABLATIVE	
legionibus	legio	NN	number=PLURAL|gender=FEMININE|case=ABLATIVE	
administrabat	administro	VB	person=PERSON_3|number=SINGULAR|tense=IMP|mood=INDICATIVE|voice=ACTIVE	
ingens	ingens	ADJ	number=SINGULAR|gender=FEMININE|case=NOMINATIVE	
novis	novus	ADJ	number=PLURAL|gender=FEMININE|case=DATIVE	
rebus	res	NN	number=PLURAL|gender=FEMININE|case=DATIVE	
materia	materia	NN	number=SINGULAR|gender=FEMININE|case=NOMINATIVE	
ut	ut	CONJ	_	
non	non	ADV	_	
in	in	PREP	_	
unum	unus	NRL	number=SINGULAR|gender=MASCULINE|case=ACCUSATIVE	
aliquem	aliquis	PRON	number=SINGULAR|gender=MASCULINE|case=ACCUSATIVE	
prono	pronus	ADJ	number=SINGULAR|gender=MASCULINE|case=ABLATIVE	
favore	favor	NN	number=SINGULAR|gender=MASCULINE|case=ABLATIVE	
ita	ita	ADV	_	
audenti	audeo	VB	number=SINGULAR|tense=PR|mood=PARTICIPLE|gender=MASCULINE|case=DATIVE	
parata	paro	VB	number=SINGULAR|tense=PERF|mood=PARTICIPLE|voice=PASSIVE|gender=FEMININE|case=NOMINATIVE	
fuit	sum	VB	person=PERSON_3|number=SINGULAR|tense=PERF|mood=INDICATIVE|voice=ACTIVE	
parata	paro	VB	number=SINGULAR|tense=PERF|mood=PARTICIPLE|voice=PASSIVE|gender=FEMININE|case=NOMINATIVE	
in	in	PREP	_	
Britannico	Britannicus	ADJ	number=SINGULAR|gender=MASCULINE|case=ABLATIVE	
exercitu	exercitus	NN	number=SINGULAR|gender=MASCULINE|case=ABLATIVE	
nihil	nihil	NN	number=SINGULAR|gender=NEUTER	
irarum	ira	NN	number=PLURAL|gender=FEMININE|case=GENITIVE	
fuit	sum	VB	person=PERSON_3|number=SINGULAR|tense=PERF|mood=INDICATIVE|voice=ACTIVE	
an	an	CONJ	_	
imperare	impero	VB	tense=PR|mood=INFINITIVE|voice=ACTIVE	
noluisset	nolo	VB	person=PERSON_3|number=SINGULAR|tense=PLUSQUAMPERFECT|mood=SUBJUNCTIVE|voice=ACTIVE	
dubium	dubius	ADJ	number=SINGULAR|gender=NEUTER|case=NOMINATIVE	
est	sum	VB	person=PERSON_3|number=SINGULAR|tense=PR|mood=INDICATIVE|voice=ACTIVE	
multi	multus	ADJ	number=PLURAL|gender=MASCULINE|case=NOMINATIVE	
ad	ad	PREP	_	
hoc	hic	PRON	number=SINGULAR|gender=NEUTER|case=ACCUSATIVE	
numeri	numerus	NN	number=PLURAL|gender=MASCULINE|case=NOMINATIVE	
e	ex	PREP	_	
Germania	Germania	NN	number=SINGULAR|gender=FEMININE|case=ABLATIVE	
ac	atque	CONJ	_	
Britannia	Britannia	NN	number=SINGULAR|gender=FEMININE|case=ABLATIVE	
et	et	CONJ	_	
Illyrico	Illyricum	NN	number=SINGULAR|gender=NEUTER|case=ABLATIVE	
quos	qui	PRON	number=PLURAL|gender=MASCULINE|case=ACCUSATIVE	
idem	idem	PRON	number=SINGULAR|gender=MASCULINE|case=NOMINATIVE	
Nero	Nero	NN	number=SINGULAR|gender=MASCULINE|case=NOMINATIVE	
electos	eligo	VB	number=PLURAL|tense=PERF|mood=PARTICIPLE|voice=PASSIVE|gender=MASCULINE|case=ACCUSATIVE	
praemissos	praemitto	VB	number=PLURAL|tense=PERF|mood=PARTICIPLE|voice=PASSIVE|gender=MASCULINE|case=ACCUSATIVE	
-que	que	CONJ	_	
ad	ad	PREP	_	
claustra	claustra	NN	number=PLURAL|gender=NEUTER|case=ACCUSATIVE	
Caspiarum	Caspius	ADJ	number=PLURAL|gender=FEMININE|case=GENITIVE	
et	et	CONJ	_	
bellum	bellum	NN	number=SINGULAR|gender=NEUTER|case=ACCUSATIVE	
quod	qui	PRON	number=SINGULAR|gender=NEUTER|case=ACCUSATIVE	
in	in	PREP	_	
Albanos	Albanus	ADJ	number=PLURAL|gender=MASCULINE|case=ACCUSATIVE	
parabat	paro	VB	person=PERSON_3|number=SINGULAR|tense=IMP|mood=INDICATIVE|voice=ACTIVE	
opprimendis	opprimo	VB	number=PLURAL|mood=GERUNDIVE|gender=NEUTER|case=DATIVE	
Vindicis	Vindex	NN	number=SINGULAR|gender=MASCULINE|case=GENITIVE	
coeptis	coepio	VB	number=PLURAL|tense=PERF|mood=PARTICIPLE|voice=PASSIVE|gender=NEUTER|case=DATIVE	
revocaverat	revoco	VB	person=PERSON_3|number=SINGULAR|tense=PLUSQUAMPERFECT|mood=INDICATIVE|voice=ACTIVE	
fuerunt	sum	VB	person=PERSON_3|number=PLURAL|tense=PERF|mood=INDICATIVE|voice=ACTIVE	
quippe	quippe	ADV	_	
Titum	Titus	NN	number=SINGULAR|gender=MASCULINE|case=ACCUSATIVE	
filium	filius	NN	number=SINGULAR|gender=MASCULINE|case=ACCUSATIVE	
ad	ad	PREP	_	
venerationem	veneratio	NN	number=SINGULAR|gender=FEMININE|case=ACCUSATIVE	
cultum	cultus	NN	number=SINGULAR|gender=MASCULINE|case=ACCUSATIVE	
-que	que	CONJ	_	
eius	is	PRON	number=SINGULAR|gender=MASCULINE|case=GENITIVE	
miserat	mitto	VB	person=PERSON_3|number=SINGULAR|tense=PLUSQUAMPERFECT|mood=INDICATIVE|voice=ACTIVE	
ut	ut	CONJ	_	
suo	suus	PRON	number=SINGULAR|gender=MASCULINE|case=ABLATIVE	
loco	locus	NN	number=SINGULAR|gender=MASCULINE|case=ABLATIVE	
memorabimus	memoro	VB	person=PERSON_1|number=PLURAL|tense=FUTURE|mood=INDICATIVE|voice=ACTIVE	
Aegyptum	Aegyptus	NN	number=SINGULAR|gender=MASCULINE|case=ACCUSATIVE	
copias	copia	NN	number=PLURAL|gender=FEMININE|case=ACCUSATIVE	
-que	que	CONJ	_	
quibus	qui	PRON	number=PLURAL|gender=FEMININE|case=ABLATIVE	
coerceretur	coerceo	VB	person=PERSON_3|number=SINGULAR|tense=IMP|mood=SUBJUNCTIVE|voice=PASSIVE	
iam	jam	ADV	_	
inde	inde	ADV	_	
a	ab	PREP	_	
divo	divus	ADJ	number=SINGULAR|gender=MASCULINE|case=ABLATIVE	
Augusto	Augustus	NN	number=SINGULAR|gender=MASCULINE|case=ABLATIVE	
equites	eques	NN	number=PLURAL|gender=MASCULINE|case=NOMINATIVE	
Romani	Romanus	ADJ	number=PLURAL|gender=MASCULINE|case=NOMINATIVE	
obtinent	obtineo	VB	person=PERSON_3|number=PLURAL|tense=PR|mood=INDICATIVE|voice=ACTIVE	
loco	locus	NN	number=SINGULAR|gender=MASCULINE|case=ABLATIVE	
regum	rex	NN	number=PLURAL|gender=MASCULINE|case=GENITIVE	
hic	hic	PRON	number=SINGULAR|gender=MASCULINE|case=NOMINATIVE	
fuit	sum	VB	person=PERSON_3|number=SINGULAR|tense=PERF|mood=INDICATIVE|voice=ACTIVE	
rerum	res	NN	number=PLURAL|gender=FEMININE|case=GENITIVE	
Romanarum	Romanus	ADJ	number=PLURAL|gender=FEMININE|case=GENITIVE	
status	status	NN	number=SINGULAR|gender=MASCULINE|case=NOMINATIVE	
cum	cum	CONJ	_	
Servius	Servius	NN	number=SINGULAR|gender=MASCULINE|case=NOMINATIVE	
Galba	Galba	NN	number=SINGULAR|gender=MASCULINE|case=NOMINATIVE	
iterum	iterum	ADV	_	
Titus	Titus	NN	number=SINGULAR|gender=MASCULINE|case=NOMINATIVE	
Vinius	Vinius	NN	number=SINGULAR|gender=MASCULINE|case=NOMINATIVE	
consules	consul	NN	number=PLURAL|gender=MASCULINE|case=NOMINATIVE	
inchoavere	incoho	VB	person=PERSON_3|number=PLURAL|tense=PERF|mood=INDICATIVE|voice=ACTIVE	
annum	annus	NN	number=SINGULAR|gender=MASCULINE|case=ACCUSATIVE	
sibi	sui	PRON	number=PLURAL|gender=MASCULINE|case=DATIVE	
ultimum	ulter	ADJ	number=SINGULAR|gender=MASCULINE|case=ACCUSATIVE|degree=SUPERLATIVE	
rei	res	NN	number=SINGULAR|gender=FEMININE|case=GENITIVE	
publicae	publicus	ADJ	number=SINGULAR|gender=FEMININE|case=GENITIVE	
prope	prope	ADV	_	
supremum	superus	ADJ	number=SINGULAR|gender=MASCULINE|case=ACCUSATIVE|degree=SUPERLATIVE	
adeo	adeo	ADV	_	
furentes	furo	VB	number=PLURAL|tense=PR|mood=PARTICIPLE|gender=MASCULINE|case=NOMINATIVE	
infirmitate	infirmitas	NN	number=SINGULAR|gender=FEMININE|case=ABLATIVE	
retinentis	retineo	VB	number=SINGULAR|tense=PR|mood=PARTICIPLE|gender=MASCULINE|case=GENITIVE	
ultro	ultro	ADV	_	
accendebantur	accendo	VB	person=PERSON_3|number=PLURAL|tense=IMP|mood=INDICATIVE|voice=PASSIVE	
est	sum	VB	person=PERSON_3|number=SINGULAR|tense=PR|mood=INDICATIVE|voice=ACTIVE	
tibi	tu	PRON	number=SINGULAR|gender=MASCULINE|case=DATIVE	
frater	frater	NN	number=SINGULAR|gender=MASCULINE|case=NOMINATIVE	
pari	par	ADJ	number=SINGULAR|gender=FEMININE|case=ABLATIVE	
nobilitate	nobilitas	NN	number=SINGULAR|gender=FEMININE|case=ABLATIVE	
natu	natus	NN	number=SINGULAR|gender=MASCULINE|case=ABLATIVE	
maior	magnus	ADJ	number=SINGULAR|gender=MASCULINE|case=NOMINATIVE|degree=COMPARATIVE	
dignus	dignus	ADJ	number=SINGULAR|gender=MASCULINE|case=NOMINATIVE	
hac	hic	PRON	number=SINGULAR|gender=FEMININE|case=ABLATIVE	
fortuna	fortuna	NN	number=SINGULAR|gender=FEMININE|case=ABLATIVE	
nisi	nisi	CONJ	_	
tu	tu	PRON	number=SINGULAR|gender=MASCULINE|case=NOMINATIVE	
potior	potis	ADJ	number=SINGULAR|gender=MASCULINE|case=NOMINATIVE|degree=COMPARATIVE	
esses	sum	VB	person=PERSON_2|number=SINGULAR|tense=IMP|mood=SUBJUNCTIVE|voice=ACTIVE	
comitatae	comitor	VB	number=PLURAL|tense=PERF|mood=PARTICIPLE|voice=DEPONENS|gender=FEMININE|case=NOMINATIVE	
profugos	profugus	ADJ	number=PLURAL|gender=MASCULINE|case=ACCUSATIVE	
liberos	liber	NN	number=PLURAL|gender=MASCULINE|case=ACCUSATIVE	
matres	mater	NN	number=PLURAL|gender=FEMININE|case=NOMINATIVE	
secutae	sequor	VB	number=PLURAL|tense=PERF|mood=PARTICIPLE|voice=DEPONENS|gender=FEMININE|case=NOMINATIVE	
maritos	maritus	ADJ	number=PLURAL|gender=MASCULINE|case=ACCUSATIVE	
in	in	PREP	_	
exilia	exsilium	NN	number=PLURAL|gender=NEUTER|case=ACCUSATIVE	
coniuges	conjunx	NN	number=PLURAL|gender=FEMININE|case=NOMINATIVE	
maturavit	maturo	VB	person=PERSON_3|number=SINGULAR|tense=PERF|mood=INDICATIVE|voice=ACTIVE	
ea	is	PRON	number=SINGULAR|gender=FEMININE|case=NOMINATIVE	
res	res	NN	number=SINGULAR|gender=FEMININE|case=NOMINATIVE	
consilium	consilium	NN	number=SINGULAR|gender=NEUTER|case=ACCUSATIVE	
Galbae	Galba	NN	number=SINGULAR|gender=MASCULINE|case=GENITIVE	
iam	jam	ADV	_	
pridem	pridem	ADV	_	
de	de	PREP	_	
adoptione	adoptio	NN	number=SINGULAR|gender=FEMININE|case=ABLATIVE	
secum	sui	PRON	number=SINGULAR|gender=MASCULINE|case=ABLATIVE	
et	et	CONJ	_	
cum	cum	PREP	_	
proximis	propior	ADJ	number=PLURAL|gender=MASCULINE|case=ABLATIVE|degree=SUPERLATIVE	
agitantis	agito	VB	number=SINGULAR|tense=PR|mood=PARTICIPLE|gender=MASCULINE|case=GENITIVE	
ac	atque	CONJ	_	
si	si	CONJ	_	
nocentem	noceo	VB	number=SINGULAR|tense=PR|mood=PARTICIPLE|gender=MASCULINE|case=ACCUSATIVE	
innocentem	innocens	ADJ	number=SINGULAR|gender=MASCULINE|case=ACCUSATIVE	
-que	que	CONJ	_	
idem	idem	PRON	number=SINGULAR|gender=MASCULINE|case=NOMINATIVE	
exitus	exitus	NN	number=SINGULAR|gender=MASCULINE|case=NOMINATIVE	
maneat	maneo	VB	person=PERSON_3|number=SINGULAR|tense=PR|mood=SUBJUNCTIVE|voice=ACTIVE	
acrioris	acer	ADJ	number=SINGULAR|gender=MASCULINE|case=GENITIVE|degree=COMPARATIVE	
viri	vir	NN	number=SINGULAR|gender=MASCULINE|case=GENITIVE	
esse	sum	VB	tense=PR|mood=INFINITIVE|voice=ACTIVE	
merito	mereo	ADV	_	
perire	pereo	VB	tense=PR|mood=INFINITIVE|voice=ACTIVE	
ipsa	ipse	PRON	number=SINGULAR|gender=FEMININE|case=NOMINATIVE	
aetas	aetas	NN	number=SINGULAR|gender=FEMININE|case=NOMINATIVE	
Galbae	Galba	NN	number=SINGULAR|gender=MASCULINE|case=GENITIVE	
inrisui	irrisus	NN	number=SINGULAR|gender=MASCULINE|case=DATIVE	
ac	atque	CONJ	_	
fastidio	fastidium	NN	number=SINGULAR|gender=NEUTER|case=DATIVE	
erat	sum	VB	person=PERSON_3|number=SINGULAR|tense=IMP|mood=INDICATIVE|voice=ACTIVE	
adsuetis	assuesco	VB	number=PLURAL|tense=PERF|mood=PARTICIPLE|voice=PASSIVE|gender=MASCULINE|case=DATIVE	
iuventae	juventa	NN	number=SINGULAR|gender=FEMININE|case=DATIVE	
Neronis	Nero	NN	number=SINGULAR|gender=MASCULINE|case=GENITIVE	
et	et	CONJ	_	
imperatores	imperator	NN	number=PLURAL|gender=MASCULINE|case=ACCUSATIVE	
forma	forma	NN	number=SINGULAR|gender=FEMININE|case=ABLATIVE	
ac	atque	CONJ	_	
decore	decus	NN	number=SINGULAR|gender=NEUTER|case=ABLATIVE	
corporis	corpus	NN	number=SINGULAR|gender=NEUTER|case=GENITIVE	
ut	ut	CONJ	_	
est	sum	VB	person=PERSON_3|number=SINGULAR|tense=PR|mood=INDICATIVE|voice=ACTIVE	
mos	mos	NN	number=SINGULAR|gender=MASCULINE|case=NOMINATIVE	
vulgi	vulgus	NN	number=SINGULAR|gender=NEUTER|case=GENITIVE	
comparantibus	comparo	VB	number=PLURAL|tense=PR|mood=PARTICIPLE|gender=MASCULINE|case=DATIVE	
fidem	fides	NN	number=SINGULAR|gender=FEMININE|case=ACCUSATIVE	
libertatem	libertas	NN	number=SINGULAR|gender=FEMININE|case=ACCUSATIVE	
amicitiam	amicitia	NN	number=SINGULAR|gender=FEMININE|case=ACCUSATIVE	
praecipua	praecipuus	ADJ	number=PLURAL|gender=NEUTER|case=ACCUSATIVE	
humani	humanus	ADJ	number=SINGULAR|gender=MASCULINE|case=GENITIVE	
animi	animus	NN	number=SINGULAR|gender=MASCULINE|case=GENITIVE	
bona	bonus	ADJ	number=PLURAL|gender=NEUTER|case=ACCUSATIVE	
tu	tu	PRON	number=SINGULAR|gender=MASCULINE|case=NOMINATIVE	
quidem	quidem	ADV	_	
eadem	idem	PRON	number=SINGULAR|gender=FEMININE|case=ABLATIVE	
constantia	constantia	NN	number=SINGULAR|gender=FEMININE|case=ABLATIVE	
retinebis	retineo	VB	person=PERSON_2|number=SINGULAR|tense=FUTURE|mood=INDICATIVE|voice=ACTIVE	
sed	sed	CONJ	_	
alii	alius	ADJ	number=PLURAL|gender=MASCULINE|case=NOMINATIVE	
per	per	PREP	_	
obsequium	obsequium	NN	number=SINGULAR|gender=NEUTER|case=ACCUSATIVE	
imminuent	imminuo	VB	person=PERSON_3|number=PLURAL|tense=FUTURE|mood=INDICATIVE|voice=ACTIVE	
turbatum	turbo	VB	number=SINGULAR|tense=PERF|mood=PARTICIPLE|voice=PASSIVE|gender=NEUTER|case=NOMINATIVE	
Illyricum	Illyricum	NN	number=SINGULAR|gender=NEUTER|case=NOMINATIVE	
Galliae	Gallia	NN	number=PLURAL|gender=FEMININE|case=NOMINATIVE	
nutantes	nuto	VB	number=PLURAL|tense=PR|mood=PARTICIPLE|gender=FEMININE|case=NOMINATIVE	
perdomita	perdomo	VB	number=SINGULAR|tense=PERF|mood=PARTICIPLE|voice=PASSIVE|gender=FEMININE|case=NOMINATIVE	
Britannia	Britannia	NN	number=SINGULAR|gender=FEMININE|case=NOMINATIVE	
et	et	CONJ	_	
statim	statim	ADV	_	
omissa	omitto	VB	number=SINGULAR|tense=PERF|mood=PARTICIPLE|voice=PASSIVE|gender=FEMININE|case=NOMINATIVE	
fuerunt	sum	VB	person=PERSON_3|number=PLURAL|tense=PERF|mood=INDICATIVE|voice=ACTIVE	
finis	finis	NN	number=SINGULAR|gender=MASCULINE|case=NOMINATIVE	
Neronis	Nero	NN	number=SINGULAR|gender=MASCULINE|case=GENITIVE	
ut	ut	ADV	_	
laetus	laetus	ADJ	number=SINGULAR|gender=MASCULINE|case=NOMINATIVE	
primo	primus	NRL	number=SINGULAR|gender=MASCULINE|case=ABLATIVE	
gaudentium	gaudeo	VB	number=PLURAL|tense=PR|mood=PARTICIPLE|gender=MASCULINE|case=GENITIVE	
impetu	impetus	NN	number=SINGULAR|gender=MASCULINE|case=ABLATIVE	
fuerat	sum	VB	person=PERSON_3|number=SINGULAR|tense=PLUSQUAMPERFECT|mood=INDICATIVE|voice=ACTIVE	
ita	ita	ADV	_	
varios	varius	ADJ	number=PLURAL|gender=MASCULINE|case=ACCUSATIVE	
motus	motus	NN	number=PLURAL|gender=MASCULINE|case=ACCUSATIVE	
animorum	animus	NN	number=PLURAL|gender=MASCULINE|case=GENITIVE	
non	non	ADV	_	
modo	modo	ADV	_	
in	in	PREP	_	
urbe	urbs	NN	number=SINGULAR|gender=FEMININE|case=ABLATIVE	
apud	apud	PREP	_	
patres	pater	NN	number=PLURAL|gender=MASCULINE|case=ACCUSATIVE	
aut	aut	CONJ	_	
populum	populus	NN	number=SINGULAR|gender=MASCULINE|case=ACCUSATIVE	
aut	aut	CONJ	_	
urbanum	urbanus	ADJ	number=SINGULAR|gender=MASCULINE|case=ACCUSATIVE	
militem	miles	NN	number=SINGULAR|gender=MASCULINE|case=ACCUSATIVE	
sed	sed	CONJ	_	
omnis	omnis	ADJ	number=PLURAL|gender=FEMININE|case=ACCUSATIVE	
legiones	legio	NN	number=PLURAL|gender=FEMININE|case=ACCUSATIVE	
duces	dux	NN	number=PLURAL|gender=MASCULINE|case=ACCUSATIVE	
-que	que	CONJ	_	
conciverat	concieo	VB	person=PERSON_3|number=SINGULAR|tense=PLUSQUAMPERFECT|mood=INDICATIVE|voice=ACTIVE	
evulgato	evulgo	VB	number=SINGULAR|tense=PERF|mood=PARTICIPLE|voice=PASSIVE|gender=NEUTER|case=ABLATIVE	
imperii	imperium	NN	number=SINGULAR|gender=NEUTER|case=GENITIVE	
arcano	arcanus	ADJ	number=SINGULAR|gender=NEUTER|case=ABLATIVE	
posse	possum	VB	tense=PR|mood=INFINITIVE|voice=ACTIVE	
principem	princeps	ADJ	number=SINGULAR|gender=MASCULINE|case=ACCUSATIVE	
alibi	alibi	ADV	_	
quam	quam	ADV	_	
Romae	Roma	NN	number=SINGULAR|gender=FEMININE|case=GENITIVE	
fieri	fio	VB	tense=PR|mood=INFINITIVE|voice=PASSIVE	
conciverat	concieo	VB	person=PERSON_3|number=SINGULAR|tense=PLUSQUAMPERFECT|mood=INDICATIVE|voice=ACTIVE	
coortae	coorior	VB	number=PLURAL|tense=PERF|mood=PARTICIPLE|voice=DEPONENS|gender=FEMININE|case=NOMINATIVE	
in	in	PREP	_	
nos	nos	PRON	number=PLURAL|gender=MASCULINE|case=ACCUSATIVE	
Sarmatarum	Sarmata	NN	number=PLURAL|gender=MASCULINE|case=GENITIVE	
ac	atque	CONJ	_	
Sueborum	Suevi	NN	number=PLURAL|gender=MASCULINE|case=GENITIVE	
gentes	gens	NN	number=PLURAL|gender=FEMININE|case=NOMINATIVE	
nobilitatus	nobilito	VB	number=SINGULAR|tense=PERF|mood=PARTICIPLE|voice=PASSIVE|gender=MASCULINE|case=NOMINATIVE	
cladibus	clades	NN	number=PLURAL|gender=FEMININE|case=ABLATIVE	
mutuis	mutuus	ADJ	number=PLURAL|gender=FEMININE|case=ABLATIVE	
Dacus	Daci	NN	number=SINGULAR|gender=MASCULINE|case=NOMINATIVE	
mota	moveo	VB	number=PLURAL|tense=PERF|mood=PARTICIPLE|voice=PASSIVE|gender=NEUTER|case=NOMINATIVE	
prope	prope	ADV	_	
etiam	etiam	CONJ	_	
Parthorum	Parthi	NN	number=PLURAL|gender=MASCULINE|case=GENITIVE	
arma	arma	NN	number=PLURAL|gender=NEUTER|case=NOMINATIVE	
falsi	fallo	VB	number=SINGULAR|tense=PERF|mood=PARTICIPLE|voice=PASSIVE|gender=MASCULINE|case=GENITIVE	
Neronis	Nero	NN	number=SINGULAR|gender=MASCULINE|case=GENITIVE	
ludibrio	ludibrium	NN	number=SINGULAR|gender=NEUTER|case=ABLATIVE	
praeter	praeter	PREP	_	
multiplicis	multiplex	ADJ	number=PLURAL|gender=MASCULINE|case=ACCUSATIVE	
rerum	res	NN	number=PLURAL|gender=FEMININE|case=GENITIVE	
humanarum	humanus	ADJ	number=PLURAL|gender=FEMININE|case=GENITIVE	
casus	casus	NN	number=PLURAL|gender=MASCULINE|case=ACCUSATIVE	
caelo	caelum	NN	number=SINGULAR|gender=NEUTER|case=ABLATIVE	
terra	terra	NN	number=SINGULAR|gender=FEMININE|case=ABLATIVE	
-que	que	CONJ	_	
prodigia	prodigium	NN	number=PLURAL|gender=NEUTER|case=NOMINATIVE	
et	et	CONJ	_	
fulminum	fulmen	NN	number=PLURAL|gender=NEUTER|case=GENITIVE	
monitus	monitus	NN	number=PLURAL|gender=MASCULINE|case=NOMINATIVE	
et	et	CONJ	_	
futurorum	sum	VB	number=PLURAL|tense=FUTURE|mood=PARTICIPLE|voice=ACTIVE|gender=NEUTER|case=GENITIVE	
praesagia	praesagium	NN	number=PLURAL|gender=NEUTER|case=NOMINATIVE	
laeta	laetus	ADJ	number=PLURAL|gender=NEUTER|case=NOMINATIVE	
tristia	tristis	ADJ	number=PLURAL|gender=NEUTER|case=NOMINATIVE	
ambigua	ambiguus	ADJ	number=PLURAL|gender=NEUTER|case=NOMINATIVE	
manifesta	manifestus	ADJ	number=PLURAL|gender=NEUTER|case=NOMINATIVE	
fuerunt	sum	VB	person=PERSON_3|number=PLURAL|tense=PERF|mood=INDICATIVE|voice=ACTIVE	
et	et	CONJ	_	
Galba	Galba	NN	number=SINGULAR|gender=MASCULINE|case=NOMINATIVE	
quidem	quidem	ADV	_	
haec	hic	PRON	number=PLURAL|gender=NEUTER|case=ACCUSATIVE	
ac	atque	CONJ	_	
talia	talis	ADJ	number=PLURAL|gender=NEUTER|case=ACCUSATIVE	
tamquam	tamquam	ADV	_	
principem	princeps	ADJ	number=SINGULAR|gender=MASCULINE|case=ACCUSATIVE	
faceret	facio	VB	person=PERSON_3|number=SINGULAR|tense=IMP|mood=SUBJUNCTIVE|voice=ACTIVE	
ceteri	ceterus	ADJ	number=PLURAL|gender=MASCULINE|case=NOMINATIVE	
tamquam	tamquam	ADV	_	
cum	cum	PREP	_	
facto	facio	VB	number=SINGULAR|tense=PERF|mood=PARTICIPLE|voice=PASSIVE|gender=MASCULINE|case=ABLATIVE	
loquebantur	loquor	VB	person=PERSON_3|number=PLURAL|tense=IMP|mood=INDICATIVE|voice=DEPONENS	
loquebatur	loquor	VB	person=PERSON_3|number=SINGULAR|tense=IMP|mood=INDICATIVE|voice=DEPONENS	
nec	neque	CONJ	_	
remedium	remedium	NN	number=SINGULAR|gender=NEUTER|case=NOMINATIVE	
in	in	PREP	_	
ceteros	ceterus	ADJ	number=PLURAL|gender=MASCULINE|case=ACCUSATIVE	
fuit	sum	VB	person=PERSON_3|number=SINGULAR|tense=PERF|mood=INDICATIVE|voice=ACTIVE	
sed	sed	CONJ	_	
metus	metus	NN	number=SINGULAR|gender=MASCULINE|case=GENITIVE	
initium	initium	NN	number=SINGULAR|gender=NEUTER|case=NOMINATIVE	
tamquam	tamquam	ADV	_	
per	per	PREP	_	
artem	ars	NN	number=SINGULAR|gender=FEMININE|case=ACCUSATIVE	
et	et	CONJ	_	
formidine	formido	NN	number=SINGULAR|gender=FEMININE|case=ABLATIVE	
singuli	singuli	NRL	number=PLURAL|gender=MASCULINE|case=NOMINATIVE	
pellerentur	pello	VB	person=PERSON_3|number=PLURAL|tense=IMP|mood=SUBJUNCTIVE|voice=PASSIVE	
omnibus	omnis	ADJ	number=PLURAL|gender=MASCULINE|case=ABLATIVE	
suspectis	suspicio	VB	number=PLURAL|tense=PERF|mood=PARTICIPLE|voice=PASSIVE|gender=MASCULINE|case=ABLATIVE	
fingebat	fingo	VB	person=PERSON_3|number=SINGULAR|tense=IMP|mood=INDICATIVE|voice=ACTIVE	
et	et	CONJ	_	
metum	metus	NN	number=SINGULAR|gender=MASCULINE|case=ACCUSATIVE	
quo	quo	ADV	_	
magis	magnus	ADV	degree=COMPARATIVE	
concupisceret	concupisco	VB	person=PERSON_3|number=SINGULAR|tense=IMP|mood=SUBJUNCTIVE|voice=ACTIVE	
tarde	tardus	ADV	_	
a	ab	PREP	_	
Nerone	Nero	NN	number=SINGULAR|gender=MASCULINE|case=ABLATIVE	
desciverant	descisco	VB	person=PERSON_3|number=PLURAL|tense=PLUSQUAMPERFECT|mood=INDICATIVE|voice=ACTIVE	
nec	neque	CONJ	_	
statim	statim	ADV	_	
pro	pro	PREP	_	
Galba	Galba	NN	number=SINGULAR|gender=MASCULINE|case=ABLATIVE	
Verginius	Verginius	NN	number=SINGULAR|gender=MASCULINE|case=NOMINATIVE	
fuerat	sum	VB	person=PERSON_3|number=SINGULAR|tense=PLUSQUAMPERFECT|mood=INDICATIVE|voice=ACTIVE	
dux	dux	NN	number=SINGULAR|gender=MASCULINE|case=NOMINATIVE	
deerat	desum	VB	person=PERSON_3|number=SINGULAR|tense=IMP|mood=INDICATIVE|voice=ACTIVE	
abducto	abduco	VB	number=SINGULAR|tense=PERF|mood=PARTICIPLE|voice=PASSIVE|gender=MASCULINE|case=ABLATIVE	
Verginio	Verginius	NN	number=SINGULAR|gender=MASCULINE|case=ABLATIVE	
per	per	PREP	_	
simulationem	simulatio	NN	number=SINGULAR|gender=FEMININE|case=ACCUSATIVE	
amicitiae	amicitia	NN	number=SINGULAR|gender=FEMININE|case=GENITIVE	
